x,y,number,ground_area,floor_area,residential_ground_area,residential_floor_area,economic_activity_ground_area,economic_activity_floor_area,cultural_ground_area,cultural_floor_area
0,26,0.47,75,75,0,0,75,75,0,0
0,27,0.67,131,131,0,0,131,131,0,0
0,38,1,1283,1283,0,0,1283,1283,0,0
0,68,0.51,38,38,38,38,0,0,0,0
0,69,0.15,12,12,12,12,0,0,0,0
1,26,0.87,65,65,0,0,65,65,0,0
1,37,2,1290,1290,0,0,1290,1290,0,0
1,40,0.06,10,10,0,0,10,10,10,10
1,41,0.94,169,169,0,0,169,169,169,169
1,68,0.19,15,15,15,15,0,0,0,0
1,69,1.15,36,36,36,36,0,0,0,0
2,20,1,127,127,127,127,0,0,0,0
4,20,1,27,27,27,27,0,0,0,0
4,30,0.85,229,229,0,0,229,229,0,0
4,31,0.15,42,42,0,0,42,42,0,0
4,32,1,734,734,0,0,734,734,0,0
4,33,0.12,318,318,0,0,318,318,0,0
5,20,1,394,394,0,0,394,394,0,0
5,32,1.08,365,365,0,0,365,365,0,0
5,33,2.3,3630,3630,105,105,3525,3525,0,0
6,33,1.48,613,613,0,0,613,613,0,0
6,34,2,539,539,0,0,539,539,0,0
7,33,0.02,6,6,0,0,6,6,0,0
9,20,0.69,25,25,25,25,0,0,0,0
9,21,2.31,268,268,268,268,0,0,0,0
10,23,0.16,7,7,7,7,0,0,0,0
11,22,3,319,319,319,319,0,0,0,0
11,23,1.84,76,76,76,76,0,0,0,0
14,38,1,197,197,197,197,0,0,0,0
16,50,1,100,100,0,0,100,100,0,0
17,66,1,50,50,50,50,0,0,0,0
18,12,1,27,27,0,0,27,27,0,0
18,13,1,41,41,0,0,41,41,0,0
19,12,1,71,71,0,0,71,71,0,0
19,13,1,186,186,186,186,0,0,0,0
24,20,0.57,1020,1020,0,0,1020,1020,0,0
25,20,0.43,766,766,0,0,766,766,0,0
25,28,0.63,188,188,188,188,0,0,0,0
26,15,1,127,127,127,127,0,0,0,0
26,22,1,21,21,21,21,0,0,0,0
26,28,0.37,110,110,110,110,0,0,0,0
26,50,1,177,177,0,0,177,177,0,0
28,36,2,497,497,0,0,497,497,0,0
28,37,1.83,627,627,0,0,627,627,0,0
29,37,0.17,67,67,0,0,67,67,0,0
30,28,1,464,464,0,0,464,464,0,0
32,8,1,16,16,0,0,16,16,0,0
33,8,1,19,19,0,0,19,19,0,0
33,10,0.4,179,179,179,179,0,0,0,0
33,11,1.03,50,50,50,50,0,0,0,0
34,10,0.54,241,241,241,241,0,0,0,0
34,11,0.04,19,19,19,19,0,0,0,0
35,40,0.01,7,7,0,0,7,7,0,0
36,39,0.19,125,125,0,0,125,125,0,0
36,40,2.8,1063,1063,0,0,1063,1063,0,0
37,39,1,133,133,0,0,133,133,0,0
45,25,1.86,547,547,0,0,547,547,0,0
45,26,1.6,230,230,46,46,184,184,0,0
46,24,3,640,640,0,0,640,640,0,0
46,25,1.14,40,40,0,0,15,15,0,0
46,26,0.4,58,58,11,11,47,47,0,0
47,35,1,292,292,292,292,0,0,0,0
47,36,2,153,153,0,0,153,153,0,0
54,12,1,11,11,0,0,11,11,0,0
67,12,1,5,5,0,0,5,5,0,0
85,0,1,110,110,110,110,0,0,0,0
91,7,0.15,35,35,35,35,0,0,0,0
91,8,0.85,204,204,204,204,0,0,0,0
