x,y,number,ground_area,floor_area,residential_ground_area,residential_floor_area,economic_activity_ground_area,economic_activity_floor_area,cultural_ground_area,cultural_floor_area
15,122,1,26,26,26,26,0,0,0,0
15,125,5,341,341,339,339,2,2,2,2
16,122,1,219,219,219,219,0,0,0,0
16,123,1,209,209,209,209,0,0,0,0
17,121,1,4,4,4,4,0,0,0,0
17,123,8.85,1453,1453,1453,1453,0,0,0,0
17,124,4.01,2664,2664,817,817,1847,1847,0,0
17,125,1.63,1631,1631,62,62,1569,1569,0,0
17,126,0.14,2,2,2,2,0,0,0,0
18,123,1.43,614,614,614,614,0,0,0,0
18,124,2.27,1231,1231,183,183,1048,1048,0,0
18,125,0.17,940,940,0,0,940,940,0,0
19,123,2.19,40,40,40,40,0,0,0,0
19,124,0.32,44,44,44,44,0,0,0,0
19,125,1,21,21,21,21,0,0,0,0
15,122,1,26,26,26,26,0,0,0,0
15,125,5,341,341,339,339,2,2,2,2
16,122,1,219,219,219,219,0,0,0,0
16,123,1,209,209,209,209,0,0,0,0
17,121,1,4,4,4,4,0,0,0,0
17,123,8.85,1453,1453,1453,1453,0,0,0,0
17,124,4.01,2664,2664,817,817,1847,1847,0,0
17,125,1.63,1631,1631,62,62,1569,1569,0,0
17,126,0.14,2,2,2,2,0,0,0,0
18,123,1.43,614,614,614,614,0,0,0,0
18,124,2.27,1231,1231,183,183,1048,1048,0,0
18,125,0.17,940,940,0,0,940,940,0,0
19,123,2.19,40,40,40,40,0,0,0,0
19,124,0.32,44,44,44,44,0,0,0,0
19,125,1,21,21,21,21,0,0,0,0
