x,y,number,ground_area,floor_area,residential_ground_area,residential_floor_area,economic_activity_ground_area,economic_activity_floor_area,cultural_ground_area,cultural_floor_area
0,5,0.37,206,206,206,206,0,0,0,0
0,7,1,357,357,357,357,0,0,0,0
3,0,1,28,28,0,0,28,28,0,0
3,2,1,38,38,38,38,0,0,0,0
3,9,1,9,9,0,0,9,9,0,0
4,2,1.98,560,560,560,560,0,0,0,0
4,3,0.02,8,8,8,8,0,0,0,0
5,0,1,42,42,42,42,0,0,0,0
5,2,1,17,17,0,0,17,17,0,0
6,1,1,7,7,0,0,7,7,0,0
7,1,2,168,168,0,0,168,168,0,0
8,0,3.09,573,573,573,573,0,0,0,0
8,2,1,14,14,0,0,14,14,0,0
9,0,2.07,451,451,451,451,0,0,0,0
10,0,0.46,245,245,245,245,0,0,0,0
10,1,1,64,64,64,64,0,0,0,0
12,1,1,60,60,0,0,60,60,0,0
0,5,0.37,206,206,206,206,0,0,0,0
0,7,1,357,357,357,357,0,0,0,0
3,0,1,28,28,0,0,28,28,0,0
3,2,1,38,38,38,38,0,0,0,0
3,9,1,9,9,0,0,9,9,0,0
4,2,1.98,560,560,560,560,0,0,0,0
4,3,0.02,8,8,8,8,0,0,0,0
5,0,1,42,42,42,42,0,0,0,0
5,2,1,17,17,0,0,17,17,0,0
6,1,1,7,7,0,0,7,7,0,0
7,1,2,168,168,0,0,168,168,0,0
8,0,3.09,573,573,573,573,0,0,0,0
8,2,1,14,14,0,0,14,14,0,0
9,0,2.07,451,451,451,451,0,0,0,0
10,0,0.46,245,245,245,245,0,0,0,0
10,1,1,64,64,64,64,0,0,0,0
12,1,1,60,60,0,0,60,60,0,0
