x,y,number,ground_area,floor_area,residential_ground_area,residential_floor_area,economic_activity_ground_area,economic_activity_floor_area,cultural_ground_area,cultural_floor_area
0,6,1,165,165,165,165,0,0,0,0
0,12,1,21,21,21,21,0,0,0,0
0,20,1,209,209,209,209,0,0,0,0
0,25,0.45,253,253,253,253,0,0,0,0
0,26,1,76,76,76,76,0,0,0,0
0,31,1,138,138,138,138,0,0,0,0
0,35,2,198,198,198,198,0,0,0,0
0,37,1.51,2104,2104,0,0,2104,2104,0,0
0,38,1.11,249,249,0,0,249,249,0,0
0,39,0.31,3864,3864,0,0,3864,3864,0,0
0,40,0.99,75,75,52,52,23,23,0,0
0,41,0.02,1,1,1,1,0,0,0,0
0,47,1,10,10,10,10,0,0,0,0
0,50,1,45,45,45,45,0,0,0,0
0,56,1,49,49,49,49,0,0,0,0
1,3,1,42,42,42,42,0,0,0,0
1,4,2,227,227,227,227,0,0,0,0
1,16,1.62,547,547,547,547,0,0,0,0
1,17,1.07,224,224,224,224,0,0,0,0
1,20,1,199,199,199,199,0,0,0,0
1,35,1.62,476,476,476,476,0,0,0,0
1,36,2.68,567,567,567,567,0,0,0,0
1,37,1,88,88,0,0,88,88,0,0
1,38,3.14,3641,3641,0,0,3641,3641,0,0
1,39,0.24,1083,1083,0,0,1083,1083,0,0
1,44,1,36,36,0,0,36,36,0,0
1,88,1,40,40,40,40,0,0,0,0
2,3,1,68,68,68,68,0,0,0,0
2,7,1,171,171,171,171,0,0,0,0
2,12,0.28,93,93,93,93,0,0,0,0
2,17,0.31,17,17,17,17,0,0,0,0
2,23,1.11,43,43,43,43,0,0,0,0
2,35,4.61,750,750,750,750,0,0,0,0
2,36,1.56,183,183,183,183,0,0,0,0
2,37,1,90,90,0,0,90,90,0,0
2,38,2.2,2712,2712,0,0,2712,2712,0,0
2,39,3.08,5652,5652,0,0,5652,5652,0,0
2,40,4.05,793,793,0,0,793,793,0,0
2,41,0.02,232,232,0,0,232,232,0,0
2,45,0.56,20,20,0,0,20,20,0,0
2,46,0.44,16,16,0,0,16,16,0,0
2,51,0.55,123,123,123,123,0,0,0,0
2,52,0.42,95,95,95,95,0,0,0,0
2,102,0.59,66,66,66,66,0,0,0,0
3,7,1,104,104,104,104,0,0,0,0
3,9,1,22,22,22,22,0,0,0,0
3,12,0.72,235,235,235,235,0,0,0,0
3,19,2,307,307,307,307,0,0,0,0
3,23,1.03,149,149,149,149,0,0,0,0
3,24,1.11,73,73,73,73,0,0,0,0
3,33,0.05,474,474,0,0,474,474,0,0
3,34,0.97,354,354,0,0,354,354,0,0
3,36,2.45,3065,3065,3065,3065,0,0,0,0
3,37,1.08,396,396,396,396,0,0,0,0
3,38,1.73,71,71,0,0,71,71,0,0
3,39,2.66,676,676,0,0,676,676,0,0
3,40,0.73,3262,3262,0,0,3262,3262,0,0
3,41,0.56,7793,7793,0,0,7793,7793,0,0
3,42,0.02,318,318,0,0,318,318,0,0
3,44,1,36,36,0,0,36,36,0,0
3,51,0.03,6,6,6,6,0,0,0,0
3,102,1.41,150,150,150,150,0,0,0,0
3,105,1,55,55,55,55,0,0,0,0
3,118,2,70,70,70,70,0,0,0,0
4,2,1.63,276,276,276,276,0,0,0,0
4,3,1.37,112,112,112,112,0,0,0,0
4,5,1,86,86,86,86,0,0,0,0
4,7,1.31,222,222,222,222,0,0,0,0
4,8,1.51,335,335,335,335,0,0,0,0
4,21,1,25,25,25,25,0,0,0,0
4,23,1.13,400,400,400,400,0,0,0,0
4,24,0.63,150,150,150,150,0,0,0,0
4,27,2,31,31,31,31,0,0,0,0
4,33,0.9,5982,5982,0,0,5982,5982,0,0
4,34,0.16,656,656,0,0,656,656,0,0
4,36,1,765,765,765,765,0,0,0,0
4,37,4,788,788,788,788,0,0,0,0
4,38,0.06,657,657,0,0,657,657,0,0
4,39,0.78,7333,7333,0,0,7333,7333,0,0
4,40,3.61,5595,5595,0,0,5595,5595,0,0
4,41,0.8,5190,5190,0,0,5190,5190,0,0
4,42,0.33,1158,1158,0,0,1158,1158,0,0
4,44,2,38,38,0,0,38,38,0,0
4,50,2,5,5,5,5,0,0,0,0
4,52,2,308,308,308,308,0,0,0,0
4,95,2,53,53,53,53,0,0,0,0
5,3,4.47,739,739,739,739,0,0,0,0
5,4,2.53,372,372,372,372,0,0,0,0
5,7,0.02,4,4,4,4,0,0,0,0
5,8,0.16,33,33,33,33,0,0,0,0
5,9,0.13,285,285,285,285,0,0,0,0
5,10,0.01,22,22,22,22,0,0,0,0
5,17,1.09,38,38,38,38,0,0,0,0
5,18,3.89,316,316,316,316,0,0,0,0
5,19,2,171,171,171,171,0,0,0,0
5,25,1,22,22,22,22,0,0,0,0
5,26,1,97,97,97,97,0,0,0,0
5,31,0.14,1798,1798,0,0,1798,1798,0,0
5,32,0.59,7507,7507,0,0,7507,7507,0,0
5,33,1.98,4906,4906,0,0,4906,4906,0,0
5,34,0.93,135,135,0,0,135,135,0,0
5,37,2,418,418,418,418,0,0,0,0
5,39,0.18,1955,1955,0,0,1955,1955,0,0
5,40,1.4,828,828,0,0,828,828,0,0
5,41,3.64,2505,2505,0,0,2505,2505,0,0
5,42,0.76,1009,1009,0,0,1009,1009,0,0
5,43,1.81,468,468,0,0,468,468,0,0
5,44,1.19,182,182,0,0,182,182,0,0
5,51,2,46,46,46,46,0,0,0,0
5,53,1,110,110,110,110,0,0,0,0
5,95,1,73,73,73,73,0,0,0,0
5,120,2,65,65,65,65,0,0,0,0
5,121,1,25,25,25,25,0,0,0,0
6,9,4.29,1341,1341,1341,1341,0,0,0,0
6,10,1.57,1328,1328,1328,1328,0,0,0,0
6,18,1.02,96,96,96,96,0,0,0,0
6,19,2.11,69,69,69,69,0,0,0,0
6,20,1.89,176,176,176,176,0,0,0,0
6,21,1,137,137,137,137,0,0,0,0
6,32,0.2,2647,2647,0,0,2647,2647,0,0
6,33,1.49,1263,1263,101,101,1162,1162,0,0
6,34,0.59,28,28,28,28,0,0,0,0
6,36,1.51,141,141,141,141,0,0,0,0
6,37,3.49,370,370,370,370,0,0,0,0
6,39,2.16,206,206,0,0,206,206,0,0
6,40,0.51,2258,2258,0,0,2258,2258,0,0
6,41,1.13,661,661,0,0,661,661,0,0
6,42,0.95,224,224,0,0,224,224,0,0
6,43,0.05,11,11,0,0,11,11,0,0
6,51,0.96,156,156,156,156,0,0,0,0
6,52,1.09,7,7,7,7,0,0,0,0
6,53,3.33,356,356,356,356,0,0,0,0
6,102,1,90,90,90,90,0,0,0,0
6,115,1,35,35,35,35,0,0,0,0
7,5,0.86,224,224,224,224,0,0,0,0
7,13,3.87,643,643,643,643,0,0,0,0
7,14,5.01,610,610,610,610,0,0,0,0
7,19,2,28,28,28,28,0,0,0,0
7,21,0.1,24,24,24,24,0,0,0,0
7,22,0.2,49,49,49,49,0,0,0,0
7,24,1,146,146,146,146,0,0,0,0
7,27,2,221,221,221,221,0,0,0,0
7,28,1,49,49,49,49,0,0,0,0
7,30,0.94,1378,1378,1378,1378,0,0,0,0
7,31,1.99,1727,1727,1727,1727,0,0,0,0
7,32,1.07,385,385,385,385,0,0,0,0
7,33,5.68,1381,1381,1381,1381,0,0,0,0
7,34,1.33,166,166,166,166,0,0,0,0
7,39,0.87,729,729,0,0,729,729,0,0
7,40,1.09,1333,1333,0,0,1333,1333,0,0
7,41,3.41,1984,1984,0,0,1984,1984,0,0
7,42,2.15,1944,1944,0,0,1944,1944,0,0
7,51,0.04,7,7,7,7,0,0,0,0
7,52,2,32,32,32,32,0,0,0,0
7,53,2.57,371,371,371,371,0,0,0,0
8,5,0.14,35,35,35,35,0,0,0,0
8,13,0.13,19,19,19,19,0,0,0,0
8,14,1.74,780,780,780,780,0,0,0,0
8,15,0.25,241,241,241,241,0,0,0,0
8,21,1.29,102,102,102,102,0,0,0,0
8,22,2.41,442,442,442,442,0,0,0,0
8,23,1,211,211,211,211,0,0,0,0
8,37,1,137,137,137,137,0,0,0,0
8,38,0.06,22,22,22,22,0,0,0,0
8,39,2.94,757,757,757,757,0,0,0,0
8,40,6.65,1755,1755,0,0,1755,1755,0,0
8,41,5.63,3362,3362,0,0,3362,3362,0,0
8,42,1.56,3456,3456,0,0,3456,3456,0,0
8,43,1.04,409,409,0,0,409,409,0,0
8,44,0.32,3360,3360,0,0,3360,3360,0,0
8,45,0.13,569,569,0,0,569,569,0,0
8,53,0.79,201,201,201,201,0,0,0,0
8,54,1.21,79,79,79,79,0,0,0,0
8,57,1,45,45,45,45,0,0,0,0
8,94,1,38,38,38,38,0,0,0,0
9,2,1,24,24,24,24,0,0,0,0
9,21,0.3,129,129,129,129,0,0,0,0
9,22,2.33,436,436,436,436,0,0,0,0
9,23,1,327,327,327,327,0,0,0,0
9,29,1,182,182,182,182,0,0,0,0
9,30,1,8,8,8,8,0,0,0,0
9,40,4.76,917,917,536,536,381,381,0,0
9,41,1.74,365,365,220,220,146,146,0,0
9,42,1.15,4122,4122,0,0,4122,4122,0,0
9,43,6.25,4860,4860,0,0,4860,4860,0,0
9,44,0.37,3850,3850,0,0,3850,3850,0,0
9,45,0.69,2578,2578,0,0,2578,2578,0,0
9,46,2.14,857,857,0,0,857,857,0,0
9,47,3,117,117,117,117,0,0,0,0
9,48,0.41,2,2,2,2,0,0,0,0
9,49,0.59,3,3,3,3,0,0,0,0
9,50,1,6,6,6,6,0,0,0,0
9,52,1.04,284,284,284,284,0,0,0,0
9,53,0.96,517,517,517,517,0,0,0,0
9,62,2,64,64,64,64,0,0,0,0
9,64,1,1,1,1,1,0,0,0,0
9,88,1,221,221,221,221,0,0,0,0
9,91,1,66,66,66,66,0,0,0,0
9,94,0.02,1,1,1,1,0,0,0,0
9,95,0.98,50,50,50,50,0,0,0,0
10,16,0.91,42,42,42,42,0,0,0,0
10,20,2.9,152,152,152,152,0,0,0,0
10,21,6.13,429,429,429,429,0,0,0,0
10,22,0.34,147,147,147,147,0,0,0,0
10,32,0.35,23,23,23,23,0,0,0,0
10,33,0.65,43,43,43,43,0,0,0,0
10,36,0.29,167,167,167,167,0,0,0,0
10,38,4,271,271,271,271,0,0,0,0
10,39,0.57,88,88,88,88,0,0,0,0
10,41,3.86,464,464,464,464,0,0,0,0
10,42,1.43,43,43,0,0,43,43,0,0
10,43,2.16,2067,2067,0,0,2067,2067,0,0
10,44,5.14,1847,1847,0,0,1847,1847,0,0
10,45,1.98,654,654,0,0,654,654,0,0
10,46,1.55,1183,1183,0,0,1183,1183,0,0
10,47,1.57,3966,3966,0,0,3966,3966,0,0
10,48,0.31,135,135,0,0,135,135,0,0
10,50,1,30,30,30,30,0,0,0,0
10,61,1,77,77,77,77,0,0,0,0
10,62,2,80,80,80,80,0,0,0,0
10,63,0.92,37,37,37,37,0,0,0,0
10,64,5.17,188,188,188,188,0,0,0,0
10,66,2,4,4,4,4,0,0,0,0
10,89,1.63,236,236,236,236,0,0,0,0
10,90,1.65,99,99,99,99,0,0,0,0
10,91,5.56,526,526,526,526,0,0,0,0
10,95,3.53,211,211,211,211,0,0,0,0
10,96,0.09,8,8,8,8,0,0,0,0
11,16,0.09,4,4,4,4,0,0,0,0
11,22,1,3,3,3,3,0,0,0,0
11,28,1,106,106,106,106,0,0,0,0
11,36,0.7,410,410,410,410,0,0,0,0
11,37,1.01,351,351,351,351,0,0,0,0
11,38,1,533,533,533,533,0,0,0,0
11,39,1.43,184,184,184,184,0,0,0,0
11,40,0.17,27,27,27,27,0,0,0,0
11,41,1.87,527,527,527,527,0,0,0,0
11,43,0.6,1576,1576,0,0,1576,1576,0,0
11,44,3.01,96,96,0,0,96,96,0,0
11,45,0.47,817,817,0,0,817,817,0,0
11,46,0.26,242,242,0,0,242,242,0,0
11,47,0.38,4696,4696,0,0,4696,4696,0,0
11,48,0.37,4597,4597,0,0,4597,4597,0,0
11,53,2,74,74,74,74,0,0,0,0
11,62,1,118,118,118,118,0,0,0,0
11,63,10.33,1386,1386,1386,1386,0,0,0,0
11,64,24.62,2469,2469,2469,2469,0,0,0,0
11,65,4,623,623,623,623,0,0,0,0
11,66,3,11,11,11,11,0,0,0,0
11,89,4.37,381,381,381,381,0,0,0,0
11,90,6.62,422,422,422,422,0,0,0,0
11,91,4.18,256,256,256,256,0,0,0,0
11,95,1.38,64,64,64,64,0,0,0,0
12,24,0.36,39,39,39,39,0,0,0,0
12,25,1.24,170,170,170,170,0,0,0,0
12,39,2,272,272,272,272,0,0,0,0
12,40,4.48,997,997,997,997,0,0,0,0
12,41,2.92,777,777,777,777,0,0,0,0
12,42,2.29,610,610,610,610,0,0,0,0
12,43,3.52,289,289,78,78,29,29,182,182
12,44,1.64,2689,2689,0,0,2689,2689,0,0
12,45,1.34,4359,4359,0,0,4359,4359,0,0
12,46,1.73,5845,5845,0,0,5845,5845,0,0
12,47,3.24,3060,3060,0,0,3060,3060,0,0
12,48,0.03,206,206,0,0,206,206,0,0
12,49,0.45,1732,1732,0,0,1732,1732,0,0
12,59,0.46,23,23,23,23,0,0,0,0
12,63,10.06,553,553,553,553,0,0,0,0
12,64,32.58,2376,2376,2376,2376,0,0,0,0
12,65,1.76,326,326,326,326,0,0,0,0
12,66,10.22,959,959,959,959,0,0,0,0
12,67,1.02,45,45,45,45,0,0,0,0
12,93,1,41,41,41,41,0,0,0,0
13,16,0.01,0,0,0,0,0,0,0,0
13,24,0.16,17,17,17,17,0,0,0,0
13,25,0.24,25,25,25,25,0,0,0,0
13,29,4,227,227,227,227,0,0,0,0
13,32,2.32,158,158,158,158,0,0,0,0
13,33,0.68,40,40,40,40,0,0,0,0
13,40,5.24,584,584,584,584,0,0,0,0
13,41,12.11,1353,1353,1353,1353,0,0,0,0
13,42,1.02,43,43,43,43,0,0,0,0
13,43,10.42,2286,2286,2286,2286,0,0,0,0
13,44,0.26,137,137,93,93,43,43,0,0
13,45,0.89,1093,1093,0,0,1093,1093,0,0
13,46,0.32,894,894,0,0,894,894,0,0
13,47,1.12,300,300,0,0,300,300,0,0
13,48,2.39,3295,3295,0,0,3295,3295,0,0
13,49,3.03,1355,1355,0,0,1355,1355,0,0
13,53,2,523,523,523,523,0,0,0,0
13,56,1,33,33,33,33,0,0,0,0
13,59,0.35,17,17,17,17,0,0,0,0
13,60,1.19,170,170,170,170,0,0,0,0
13,63,2.57,127,127,127,127,0,0,0,0
13,64,27.49,2196,2196,2196,2196,0,0,0,0
13,66,1,187,187,187,187,0,0,0,0
13,67,6,262,262,262,262,0,0,0,0
13,84,1,56,56,56,56,0,0,0,0
13,94,8,247,247,247,247,0,0,0,0
13,122,3,102,102,102,102,0,0,0,0
14,15,0.24,209,209,0,0,209,209,0,0
14,16,5.75,1583,1583,365,365,1217,1217,0,0
14,20,2,204,204,204,204,0,0,0,0
14,21,0.73,113,113,113,113,0,0,0,0
14,33,1,199,199,199,199,0,0,0,0
14,34,2,233,233,233,233,0,0,0,0
14,39,1,197,197,197,197,0,0,0,0
14,40,3.19,662,662,662,662,0,0,0,0
14,41,2.78,524,524,524,524,0,0,0,0
14,42,3.12,587,587,587,587,0,0,0,0
14,43,3.81,222,222,222,222,0,0,0,0
14,45,2.59,1937,1937,0,0,1937,1937,0,0
14,46,2.24,1615,1615,0,0,1615,1615,0,0
14,47,0.04,2,2,0,0,2,2,0,0
14,48,2.21,603,603,0,0,603,603,0,0
14,49,2.42,1289,1289,0,0,1289,1289,0,0
14,57,0.8,92,92,92,92,0,0,0,0
14,58,4.09,359,359,359,359,0,0,0,0
14,60,1,72,72,72,72,0,0,0,0
14,63,0.58,26,26,26,26,0,0,0,0
14,64,95.14,4274,4274,4274,4274,0,0,0,0
14,65,12.79,1112,1112,1112,1112,0,0,0,0
14,66,4.15,148,148,148,148,0,0,0,0
14,91,1.56,64,64,64,64,0,0,0,0
15,20,1.03,129,129,129,129,0,0,0,0
15,21,0.63,669,669,669,669,0,0,0,0
15,29,1,4,4,4,4,0,0,0,0
15,30,0.02,4,4,4,4,0,0,0,0
15,40,0.82,150,150,150,150,0,0,0,0
15,42,5.43,494,494,494,494,0,0,0,0
15,44,1.56,204,204,0,0,204,204,0,0
15,45,1.56,274,274,0,0,274,274,0,0
15,46,0.06,370,370,0,0,370,370,0,0
15,47,1.24,2561,2561,0,0,2561,2561,0,0
15,48,0.64,7848,7848,0,0,7848,7848,0,0
15,49,2.46,747,747,0,0,747,747,0,0
15,50,0.63,3025,3025,0,0,3025,3025,0,0
15,51,2.35,1934,1934,0,0,1934,1934,0,0
15,57,1,21,21,21,21,0,0,0,0
15,58,0.1,1,1,1,1,0,0,0,0
15,59,0.47,10,10,10,10,0,0,0,0
15,60,12.53,795,795,795,795,0,0,0,0
15,64,60.01,3022,3022,3022,3022,0,0,0,0
15,65,8.3,474,474,474,474,0,0,0,0
15,91,0.44,16,16,16,16,0,0,0,0
15,92,1,58,58,58,58,0,0,0,0
15,98,2,87,87,87,87,0,0,0,0
15,110,1,62,62,62,62,0,0,0,0
15,117,1,26,26,26,26,0,0,0,0
15,122,2,109,109,109,109,0,0,0,0
16,20,1.55,1187,1187,1187,1187,0,0,0,0
16,21,0.03,57,57,57,57,0,0,0,0
16,29,1,97,97,97,97,0,0,0,0
16,30,0.98,174,174,174,174,0,0,0,0
16,35,2.1,435,435,435,435,0,0,0,0
16,36,0.9,18,18,18,18,0,0,0,0
16,37,2,126,126,126,126,0,0,0,0
16,42,0.57,69,69,69,69,0,0,0,0
16,43,1,184,184,184,184,0,0,0,0
16,45,0.62,175,175,0,0,175,175,0,0
16,46,1.72,3140,3140,0,0,3140,3140,0,0
16,47,0.28,1719,1719,0,0,1719,1719,0,0
16,48,2.13,1682,1682,0,0,1682,1682,0,0
16,49,1.01,233,233,0,0,233,233,0,0
16,50,0.07,332,332,0,0,332,332,0,0
16,51,0.93,5711,5711,0,0,5711,5711,0,0
16,52,1.02,170,170,0,0,170,170,0,0
16,58,1,19,19,19,19,0,0,0,0
16,61,0.82,213,213,213,213,0,0,0,0
16,62,0.19,16,16,16,16,0,0,0,0
16,64,4.3,339,339,339,339,0,0,0,0
16,67,1,41,41,41,41,0,0,0,0
16,94,2,81,81,81,81,0,0,0,0
16,96,1,121,121,121,121,0,0,0,0
16,98,1,30,30,30,30,0,0,0,0
16,99,14,387,387,387,387,0,0,0,0
16,107,2,50,50,50,50,0,0,0,0
16,108,1,35,35,35,35,0,0,0,0
16,109,0.71,26,26,26,26,0,0,0,0
16,116,1.54,171,171,171,171,0,0,0,0
16,117,0.17,38,38,38,38,0,0,0,0
16,121,1,42,42,42,42,0,0,0,0
17,20,0.03,6,6,6,6,0,0,0,0
17,22,0.8,165,165,165,165,0,0,0,0
17,23,2.2,268,268,268,268,0,0,0,0
17,36,1,127,127,127,127,0,0,0,0
17,37,2,202,202,202,202,0,0,0,0
17,44,4.63,1408,1408,1408,1408,0,0,0,0
17,45,0.44,380,380,359,359,20,20,0,0
17,46,0.9,363,363,0,0,363,363,0,0
17,47,2.66,152,152,0,0,152,152,0,0
17,48,0.16,3362,3362,0,0,3362,3362,0,0
17,49,0.72,7931,7931,0,0,7931,7931,0,0
17,52,0.04,282,282,0,0,282,282,0,0
17,53,3.09,1078,1078,8,8,1070,1070,0,0
17,57,0.24,400,400,400,400,0,0,0,0
17,58,2.23,394,394,394,394,0,0,0,0
17,60,1.61,53,53,53,53,0,0,0,0
17,61,6.03,937,937,937,937,0,0,0,0
17,62,3.81,275,275,275,275,0,0,0,0
17,96,1.41,106,106,106,106,0,0,0,0
17,97,1.5,298,298,298,298,0,0,0,0
17,100,1,38,38,38,38,0,0,0,0
17,101,1,32,32,32,32,0,0,0,0
17,109,0.29,11,11,11,11,0,0,0,0
17,115,1,115,115,115,115,0,0,0,0
17,116,0.26,56,56,56,56,0,0,0,0
17,117,0.02,5,5,5,5,0,0,0,0
17,119,0.41,19,19,19,19,0,0,0,0
18,27,2,185,185,185,185,0,0,0,0
18,46,0.19,80,80,0,0,80,80,0,0
18,47,0.36,593,593,0,0,593,593,0,0
18,48,1.34,7140,7140,0,0,7140,7140,0,0
18,49,2.74,1712,1712,0,0,1712,1712,0,0
18,50,2.1,39,39,0,0,39,39,0,0
18,51,4.56,1194,1194,0,0,1194,1194,0,0
18,52,1.16,1408,1408,0,0,1408,1408,0,0
18,53,1.86,5429,5429,0,0,5429,5429,0,0
18,54,0.21,481,481,0,0,481,481,0,0
18,57,1.53,923,923,923,923,0,0,0,0
18,58,0.51,38,38,38,38,0,0,0,0
18,59,1.01,38,38,38,38,0,0,0,0
18,60,2.91,137,137,137,137,0,0,0,0
18,61,3.15,267,267,267,267,0,0,0,0
18,96,0.01,1,1,1,1,0,0,0,0
18,97,0.08,18,18,18,18,0,0,0,0
18,101,1,37,37,37,37,0,0,0,0
18,106,3,78,78,78,78,0,0,0,0
18,110,3.01,425,425,425,425,0,0,0,0
18,111,11.25,483,483,483,483,0,0,0,0
18,112,1,41,41,41,41,0,0,0,0
18,113,10.43,861,861,861,861,0,0,0,0
18,114,10.63,903,903,903,903,0,0,0,0
18,115,2.88,173,173,173,173,0,0,0,0
18,116,1,122,122,122,122,0,0,0,0
18,119,3.59,349,349,349,349,0,0,0,0
18,120,1,128,128,128,128,0,0,0,0
19,10,1,23,23,23,23,0,0,0,0
19,28,2,524,524,524,524,0,0,0,0
19,47,1,46,46,0,0,46,46,0,0
19,48,3.9,527,527,0,0,527,527,0,0
19,49,1,359,359,0,0,359,359,0,0
19,50,0.47,892,892,0,0,892,892,0,0
19,51,2.97,3100,3100,0,0,3100,3100,0,0
19,52,3.4,1828,1828,0,0,1828,1828,0,0
19,53,2.06,1734,1734,0,0,1734,1734,0,0
19,54,3.31,1341,1341,0,0,1341,1341,0,0
19,57,2,40,40,40,40,0,0,0,0
19,58,1.49,200,200,200,200,0,0,0,0
19,60,2.47,194,194,194,194,0,0,0,0
19,61,2,74,74,74,74,0,0,0,0
19,62,1,37,37,37,37,0,0,0,0
19,85,1,36,36,36,36,0,0,0,0
19,86,2,378,378,378,378,0,0,0,0
19,90,1.56,359,359,359,359,0,0,0,0
19,109,4.14,537,537,537,537,0,0,0,0
19,110,6.8,1020,1020,1020,1020,0,0,0,0
19,111,27.44,2114,2114,2114,2114,0,0,0,0
19,112,24.58,1826,1826,1826,1826,0,0,0,0
19,113,33.61,2423,2423,2423,2423,0,0,0,0
19,114,15.86,1292,1292,1292,1292,0,0,0,0
19,115,0.12,11,11,11,11,0,0,0,0
19,117,2,173,173,173,173,0,0,0,0
19,121,0.99,169,169,169,169,0,0,0,0
19,122,0.86,143,143,143,143,0,0,0,0
20,10,1,7,7,7,7,0,0,0,0
20,46,0.2,181,181,0,0,181,181,0,0
20,47,1.36,1669,1669,1,1,1668,1668,0,0
20,48,0.1,34,34,0,0,34,34,0,0
20,50,1.15,2356,2356,0,0,2356,2356,0,0
20,51,1.65,6400,6400,0,0,6400,6400,0,0
20,52,2.5,1196,1196,0,0,1196,1196,0,0
20,53,0.47,397,397,0,0,397,397,0,0
20,54,2.29,2692,2692,0,0,2692,2692,0,0
20,55,3.63,1042,1042,0,0,1042,1042,0,0
20,58,3,278,278,278,278,0,0,0,0
20,59,1,319,319,319,319,0,0,0,0
20,60,1,58,58,58,58,0,0,0,0
20,61,0.94,58,58,58,58,0,0,0,0
20,89,3,173,173,173,173,0,0,0,0
20,90,17.93,2088,2088,2088,2088,0,0,0,0
20,91,6.48,432,432,432,432,0,0,0,0
20,92,5.17,336,336,336,336,0,0,0,0
20,93,0.34,16,16,16,16,0,0,0,0
20,94,2,9,9,9,9,0,0,0,0
20,98,3.99,503,503,503,503,0,0,0,0
20,99,1.88,60,60,60,60,0,0,0,0
20,108,5.77,302,302,302,302,0,0,0,0
20,109,10.11,653,653,653,653,0,0,0,0
20,110,0.1,15,15,15,15,0,0,0,0
20,111,3.02,334,334,334,334,0,0,0,0
20,112,0.63,43,43,43,43,0,0,0,0
20,113,12.97,1300,1300,1300,1300,0,0,0,0
20,114,46.4,2290,2290,2290,2290,0,0,0,0
20,115,21.84,1126,1126,1126,1126,0,0,0,0
20,116,1,29,29,29,29,0,0,0,0
20,117,1,106,106,106,106,0,0,0,0
20,120,2,56,56,56,56,0,0,0,0
20,121,1,148,148,148,148,0,0,0,0
20,122,2.15,47,47,47,47,0,0,0,0
21,11,1,62,62,62,62,0,0,0,0
21,12,1.92,62,62,62,62,0,0,0,0
21,43,2,41,41,41,41,0,0,0,0
21,44,1,30,30,30,30,0,0,0,0
21,46,2,975,975,823,823,152,152,0,0
21,47,6.2,3571,3571,2533,2533,1038,1038,0,0
21,48,0.25,272,272,272,272,0,0,0,0
21,50,0.34,4326,4326,0,0,4326,4326,0,0
21,51,1.8,4343,4343,0,0,4343,4343,0,0
21,52,0.08,279,279,0,0,279,279,0,0
21,54,1.64,674,674,0,0,674,674,0,0
21,55,2.69,2724,2724,0,0,2724,2724,0,0
21,56,0.93,984,984,0,0,984,984,0,0
21,58,1.01,32,32,32,32,0,0,0,0
21,59,4.99,436,436,436,436,0,0,0,0
21,61,0.06,4,4,4,4,0,0,0,0
21,89,3,124,124,124,124,0,0,0,0
21,90,13.51,1262,1262,1262,1262,0,0,0,0
21,91,0.69,35,35,35,35,0,0,0,0
21,92,2.66,134,134,134,134,0,0,0,0
21,93,3.66,97,97,97,97,0,0,0,0
21,98,1.01,324,324,324,324,0,0,0,0
21,99,1.12,40,40,40,40,0,0,0,0
21,100,13.65,1038,1038,1038,1038,0,0,0,0
21,101,3.46,351,351,351,351,0,0,0,0
21,102,1,119,119,119,119,0,0,0,0
21,104,2,472,472,472,472,0,0,0,0
21,105,5.27,428,428,428,428,0,0,0,0
21,106,3.25,213,213,213,213,0,0,0,0
21,107,3.88,643,643,643,643,0,0,0,0
21,108,10.92,801,801,801,801,0,0,0,0
21,109,4,332,332,332,332,0,0,0,0
21,111,3.51,568,568,568,568,0,0,0,0
21,112,18.5,1672,1672,1672,1672,0,0,0,0
21,113,27.85,2847,2847,2847,2847,0,0,0,0
21,114,53.07,2650,2650,2650,2650,0,0,0,0
21,115,28.53,1693,1693,1693,1693,0,0,0,0
21,117,1,63,63,63,63,0,0,0,0
21,118,1,18,18,18,18,0,0,0,0
21,120,0.17,423,423,423,423,0,0,0,0
21,121,2.47,1216,1216,1216,1216,0,0,0,0
22,8,1,15,15,15,15,0,0,0,0
22,9,1,15,15,15,15,0,0,0,0
22,12,0.08,2,2,2,2,0,0,0,0
22,36,1,14,14,0,0,14,14,0,0
22,37,0.2,15,15,0,0,15,15,0,0
22,46,0.06,33,33,33,33,0,0,0,0
22,47,0.94,506,506,506,506,0,0,0,0
22,54,0.21,144,144,0,0,144,144,0,0
22,55,0.49,1223,1223,0,0,1223,1223,0,0
22,56,1.12,147,147,0,0,147,147,0,0
22,57,2,96,96,96,96,0,0,0,0
22,58,3,304,304,304,304,0,0,0,0
22,60,2,268,268,268,268,0,0,0,0
22,62,2,59,59,59,59,0,0,0,0
22,89,4,376,376,376,376,0,0,0,0
22,98,4.04,420,420,420,420,0,0,0,0
22,99,2.07,247,247,247,247,0,0,0,0
22,100,1.78,625,625,625,625,0,0,0,0
22,101,1.12,304,304,304,304,0,0,0,0
22,102,0.03,12,12,12,12,0,0,0,0
22,103,2.25,163,163,163,163,0,0,0,0
22,104,2.88,289,289,289,289,0,0,0,0
22,105,2,201,201,201,201,0,0,0,0
22,106,2.67,501,501,501,501,0,0,0,0
22,107,4.01,450,450,450,450,0,0,0,0
22,108,3.01,175,175,175,175,0,0,0,0
22,109,1,56,56,56,56,0,0,0,0
22,110,1.2,254,254,254,254,0,0,0,0
22,111,5.56,663,663,663,663,0,0,0,0
22,112,39.84,2584,2584,2397,2397,0,0,188,188
22,113,45.44,3004,3004,3004,3004,0,0,0,0
22,114,9.78,674,674,674,674,0,0,0,0
22,116,0.11,4,4,4,4,0,0,0,0
22,117,1,27,27,27,27,0,0,0,0
22,118,1,4,4,4,4,0,0,0,0
22,119,1.34,83,83,83,83,0,0,0,0
22,120,0.82,513,513,513,513,0,0,0,0
22,121,1.2,604,604,604,604,0,0,0,0
22,122,1,6,6,6,6,0,0,0,0
23,9,0.02,1,1,1,1,0,0,0,0
23,36,0.11,8,8,0,0,8,8,0,0
23,37,0.69,52,52,0,0,52,52,0,0
23,53,0.23,3360,3360,0,0,3360,3360,0,0
23,54,1.31,7357,7357,0,0,7357,7357,0,0
23,55,1,132,132,0,0,132,132,0,0
23,57,1,18,18,0,0,18,18,0,0
23,62,1,24,24,24,24,0,0,0,0
23,71,1,64,64,64,64,0,0,0,0
23,88,2.76,101,101,101,101,0,0,0,0
23,89,0.07,5,5,5,5,0,0,0,0
23,93,3,64,64,64,64,0,0,0,0
23,94,3.06,126,126,126,126,0,0,0,0
23,95,42.69,2532,2532,2532,2532,0,0,0,0
23,96,5.2,796,796,796,796,0,0,0,0
23,97,18.14,1630,1630,1630,1630,0,0,0,0
23,98,4.27,715,715,715,715,0,0,0,0
23,99,5.48,626,626,626,626,0,0,0,0
23,100,0.14,13,13,13,13,0,0,0,0
23,102,0.15,65,65,65,65,0,0,0,0
23,103,0.73,322,322,322,322,0,0,0,0
23,105,3.97,590,590,590,590,0,0,0,0
23,106,2,402,402,402,402,0,0,0,0
23,107,0.99,228,228,228,228,0,0,0,0
23,108,7,760,760,760,760,0,0,0,0
23,109,3.18,323,323,323,323,0,0,0,0
23,110,2.82,377,377,377,377,0,0,0,0
23,112,5.58,253,253,253,253,0,0,0,0
23,113,51.47,4516,4516,3835,3835,328,328,353,353
23,114,0.17,43,43,26,26,0,0,17,17
23,115,4.92,355,355,355,355,0,0,0,0
23,116,1.83,90,90,90,90,0,0,0,0
23,117,0.06,3,3,3,3,0,0,0,0
23,122,1,19,19,19,19,0,0,0,0
24,9,1.98,62,62,62,62,0,0,0,0
24,53,2.04,975,975,359,359,615,615,0,0
24,54,0.22,2985,2985,0,0,2985,2985,0,0
24,55,1.77,1334,1334,0,0,1334,1334,0,0
24,72,1.74,141,141,141,141,0,0,0,0
24,88,0.18,3,3,3,3,0,0,0,0
24,95,8.24,1046,1046,1046,1046,0,0,0,0
24,96,1.78,209,209,209,209,0,0,0,0
24,97,23.31,2129,2129,2129,2129,0,0,0,0
24,98,7.58,543,543,543,543,0,0,0,0
24,99,7.38,880,880,880,880,0,0,0,0
24,101,0.8,12,12,12,12,0,0,0,0
24,102,0.14,67,67,67,67,0,0,0,0
24,103,0.84,412,412,412,412,0,0,0,0
24,104,2,214,214,214,214,0,0,0,0
24,105,4.74,735,735,735,735,0,0,0,0
24,107,2.06,76,76,76,76,0,0,0,0
24,108,1.14,51,51,51,51,0,0,0,0
24,109,1.86,96,96,96,96,0,0,0,0
24,115,1,29,29,29,29,0,0,0,0
24,116,3,186,186,186,186,0,0,0,0
25,8,1,43,43,43,43,0,0,0,0
25,10,1,48,48,48,48,0,0,0,0
25,11,1,72,72,72,72,0,0,0,0
25,16,1,9,9,9,9,0,0,0,0
25,27,1,93,93,93,93,0,0,0,0
25,28,1,147,147,147,147,0,0,0,0
25,30,1,44,44,44,44,0,0,0,0
25,41,1,102,102,102,102,0,0,0,0
25,46,1,38,38,38,38,0,0,0,0
25,54,1.02,49,49,49,49,0,0,0,0
25,55,5.19,3476,3476,2,2,3474,3474,0,0
25,70,0.98,100,100,100,100,0,0,0,0
25,71,2,8,8,8,8,0,0,0,0
25,72,1.92,142,142,142,142,0,0,0,0
25,73,0.34,36,36,36,36,0,0,0,0
25,92,1,4,4,4,4,0,0,0,0
25,94,3.01,212,212,212,212,0,0,0,0
25,95,11.55,1041,1041,1041,1041,0,0,0,0
25,96,1.98,345,345,345,345,0,0,0,0
25,97,7.39,801,801,801,801,0,0,0,0
25,98,2.89,438,438,438,438,0,0,0,0
25,99,3.51,728,728,728,728,0,0,0,0
25,100,3.13,919,919,919,919,0,0,0,0
25,101,1.2,28,28,28,28,0,0,0,0
25,104,12.37,1025,1025,1025,1025,0,0,0,0
25,105,3.91,557,557,557,557,0,0,0,0
25,106,2,224,224,224,224,0,0,0,0
25,107,1.94,40,40,40,40,0,0,0,0
25,110,2,107,107,107,107,0,0,0,0
26,8,3,139,139,139,139,0,0,0,0
26,9,1,15,15,15,15,0,0,0,0
26,11,1,33,33,33,33,0,0,0,0
26,12,1,15,15,15,15,0,0,0,0
26,13,1,33,33,33,33,0,0,0,0
26,16,0.73,37,37,37,37,0,0,0,0
26,17,3,533,533,533,533,0,0,0,0
26,23,1,33,33,33,33,0,0,0,0
26,24,1,101,101,101,101,0,0,0,0
26,26,1,7,7,7,7,0,0,0,0
26,27,0.49,57,57,57,57,0,0,0,0
26,28,0.51,61,61,61,61,0,0,0,0
26,29,2,96,96,96,96,0,0,0,0
26,30,1,59,59,59,59,0,0,0,0
26,32,2,71,71,71,71,0,0,0,0
26,41,0.03,0,0,0,0,0,0,0,0
26,42,0.97,13,13,13,13,0,0,0,0
26,53,1,36,36,36,36,0,0,0,0
26,55,1,19,19,19,19,0,0,0,0
26,62,1,143,143,143,143,0,0,0,0
26,67,2,74,74,74,74,0,0,0,0
26,70,2.02,119,119,119,119,0,0,0,0
26,71,2.19,102,102,102,102,0,0,0,0
26,73,1,93,93,93,93,0,0,0,0
26,78,1,32,32,32,32,0,0,0,0
26,80,0.19,165,165,165,165,0,0,0,0
26,81,2.73,825,825,825,825,0,0,0,0
26,82,1,10,10,10,10,0,0,0,0
26,89,1,193,193,193,193,0,0,0,0
26,94,1.45,242,242,242,242,0,0,0,0
26,96,1.03,130,130,130,130,0,0,0,0
26,97,3.88,542,542,542,542,0,0,0,0
26,98,3.93,569,569,569,569,0,0,0,0
26,99,3.85,636,636,636,636,0,0,0,0
26,100,1.25,116,116,116,116,0,0,0,0
26,103,1,128,128,128,128,0,0,0,0
26,104,1,229,229,229,229,0,0,0,0
26,105,1,148,148,148,148,0,0,0,0
26,110,1,38,38,38,38,0,0,0,0
26,112,3.92,124,124,124,124,0,0,0,0
26,113,0.08,2,2,2,2,0,0,0,0
27,13,0.96,51,51,51,51,0,0,0,0
27,15,3.97,357,357,357,357,0,0,0,0
27,16,1.24,175,175,175,175,0,0,0,0
27,17,1.03,21,21,21,21,0,0,0,0
27,22,2.54,162,162,162,162,0,0,0,0
27,23,1,109,109,109,109,0,0,0,0
27,26,1,72,72,72,72,0,0,0,0
27,27,2,128,128,128,128,0,0,0,0
27,30,1,118,118,118,118,0,0,0,0
27,31,1.19,132,132,132,132,0,0,0,0
27,32,1.81,116,116,116,116,0,0,0,0
27,62,2.43,829,829,829,829,0,0,0,0
27,64,4,413,413,413,413,0,0,0,0
27,65,1,25,25,25,25,0,0,0,0
27,66,9.78,1007,1007,1007,1007,0,0,0,0
27,67,1,8,8,8,8,0,0,0,0
27,70,2.25,195,195,195,195,0,0,0,0
27,71,6.42,895,895,895,895,0,0,0,0
27,72,0.65,37,37,37,37,0,0,0,0
27,73,3.75,459,459,459,459,0,0,0,0
27,77,3,242,242,242,242,0,0,0,0
27,78,7,451,451,451,451,0,0,0,0
27,79,1,41,41,41,41,0,0,0,0
27,81,0.45,137,137,137,137,0,0,0,0
27,88,1,249,249,249,249,0,0,0,0
27,96,0.6,1888,1888,1888,1888,0,0,0,0
27,97,1.87,276,276,276,276,0,0,0,0
27,98,4.4,1003,1003,1003,1003,0,0,0,0
27,99,3.39,1112,1112,1112,1112,0,0,0,0
27,100,4.75,399,399,399,399,0,0,0,0
27,102,4.83,631,631,631,631,0,0,0,0
27,103,0.17,13,13,13,13,0,0,0,0
27,107,0.47,186,186,186,186,0,0,0,0
27,108,0.53,214,214,214,214,0,0,0,0
27,117,1,11,11,11,11,0,0,0,0
28,9,1.97,32,32,32,32,0,0,0,0
28,11,1,42,42,42,42,0,0,0,0
28,12,1,49,49,49,49,0,0,0,0
28,13,1.04,15,15,15,15,0,0,0,0
28,14,2.68,61,61,61,61,0,0,0,0
28,15,3.35,161,161,161,161,0,0,0,0
28,16,3,227,227,227,227,0,0,0,0
28,19,1,43,43,43,43,0,0,0,0
28,21,0.31,51,51,51,51,0,0,0,0
28,22,2.71,407,407,407,407,0,0,0,0
28,23,0.11,18,18,18,18,0,0,0,0
28,24,1,73,73,73,73,0,0,0,0
28,25,0.99,63,63,63,63,0,0,0,0
28,26,0.63,50,50,50,50,0,0,0,0
28,28,1.94,91,91,91,91,0,0,0,0
28,29,5.06,137,137,137,137,0,0,0,0
28,31,0.2,28,28,28,28,0,0,0,0
28,55,4,178,178,178,178,0,0,0,0
28,56,2.96,93,93,93,93,0,0,0,0
28,61,2.13,135,135,135,135,0,0,0,0
28,62,4.61,345,345,345,345,0,0,0,0
28,63,3.75,350,350,350,350,0,0,0,0
28,65,4,122,122,122,122,0,0,0,0
28,66,23.88,1898,1898,1898,1898,0,0,0,0
28,67,2.33,399,399,399,399,0,0,0,0
28,70,0.01,1,1,1,1,0,0,0,0
28,71,6,777,777,777,777,0,0,0,0
28,72,28.24,1204,1204,1204,1204,0,0,0,0
28,73,4.49,267,267,267,267,0,0,0,0
28,74,5.21,352,352,352,352,0,0,0,0
28,80,7.97,386,386,386,386,0,0,0,0
28,81,9.66,856,856,856,856,0,0,0,0
28,82,2,249,249,249,249,0,0,0,0
28,88,1,148,148,148,148,0,0,0,0
28,92,1,196,196,196,196,0,0,0,0
28,94,0.64,10,10,10,10,0,0,0,0
28,95,1,8,8,8,8,0,0,0,0
28,96,0.99,1678,1678,1678,1678,0,0,0,0
28,97,1.11,487,487,487,487,0,0,0,0
28,98,4.4,660,660,660,660,0,0,0,0
28,99,1.67,221,221,221,221,0,0,0,0
28,100,6.81,653,653,653,653,0,0,0,0
28,101,1.19,123,123,123,123,0,0,0,0
28,104,1,14,14,14,14,0,0,0,0
28,106,2,56,56,56,56,0,0,0,0
29,7,1,26,26,26,26,0,0,0,0
29,9,1.03,163,163,163,163,0,0,0,0
29,11,1,105,105,105,105,0,0,0,0
29,13,1,85,85,85,85,0,0,0,0
29,14,1,94,94,94,94,0,0,0,0
29,19,1,64,64,64,64,0,0,0,0
29,22,0.32,52,52,52,52,0,0,0,0
29,25,4.15,435,435,435,435,0,0,0,0
29,26,0.37,29,29,29,29,0,0,0,0
29,30,2,438,438,438,438,0,0,0,0
29,31,3.49,479,479,479,479,0,0,0,0
29,34,0.29,29,29,29,29,0,0,0,0
29,35,0.78,78,78,78,78,0,0,0,0
29,56,0.04,1,1,1,1,0,0,0,0
29,58,1.56,1291,1291,417,417,874,874,0,0
29,59,0.68,727,727,727,727,0,0,0,0
29,61,4.58,110,110,110,110,0,0,0,0
29,62,2.24,337,337,169,169,168,168,0,0
29,63,0.25,15,15,15,15,0,0,0,0
29,65,21.32,1845,1845,1845,1845,0,0,0,0
29,66,2.01,185,185,185,185,0,0,0,0
29,67,2,176,176,176,176,0,0,0,0
29,68,6.53,646,646,646,646,0,0,0,0
29,72,37.51,2099,2099,2099,2099,0,0,0,0
29,73,10.5,611,611,611,611,0,0,0,0
29,74,1.79,608,608,608,608,0,0,0,0
29,78,5,189,189,189,189,0,0,0,0
29,82,1,24,24,24,24,0,0,0,0
29,92,0.83,45,45,45,45,0,0,0,0
29,93,5.99,831,831,831,831,0,0,0,0
29,94,0.79,39,39,39,39,0,0,0,0
29,95,0.68,3,3,3,3,0,0,0,0
29,96,2,321,321,321,321,0,0,0,0
29,97,1.48,606,606,606,606,0,0,0,0
29,98,0.08,34,34,34,34,0,0,0,0
29,100,1,73,73,73,73,0,0,0,0
29,104,1.74,66,66,66,66,0,0,0,0
29,105,2.37,77,77,77,77,0,0,0,0
29,117,1,4,4,4,4,0,0,0,0
30,10,1,19,19,19,19,0,0,0,0
30,16,1,59,59,59,59,0,0,0,0
30,24,2,147,147,147,147,0,0,0,0
30,25,1.86,494,494,494,494,0,0,0,0
30,29,5.06,1037,1037,1037,1037,0,0,0,0
30,30,0.19,134,134,134,134,0,0,0,0
30,31,0.31,43,43,43,43,0,0,0,0
30,34,3.71,626,626,626,626,0,0,0,0
30,35,0.22,22,22,22,22,0,0,0,0
30,56,0.27,287,287,287,287,0,0,0,0
30,57,1,1212,1212,1212,1212,1,1,0,0
30,58,1.82,2938,2938,118,118,2820,2820,0,0
30,59,1,1081,1081,1081,1081,0,0,0,0
30,62,2,93,93,93,93,0,0,0,0
30,63,3.76,601,601,517,517,84,84,0,0
30,64,1.17,165,165,165,165,0,0,0,0
30,65,12.3,1085,1085,1085,1085,0,0,0,0
30,66,0.2,16,16,16,16,0,0,0,0
30,68,9.45,867,867,867,867,0,0,0,0
30,69,2.53,533,533,533,533,0,0,0,0
30,82,3.62,111,111,111,111,0,0,0,0
30,83,6.38,236,236,236,236,0,0,0,0
30,88,0.22,84,84,84,84,0,0,0,0
30,89,1.13,57,57,57,57,0,0,0,0
30,93,0.06,18,18,18,18,0,0,0,0
30,104,0.31,14,14,14,14,0,0,0,0
30,105,2.58,86,86,86,86,0,0,0,0
30,106,0.78,6,6,6,6,0,0,0,0
30,107,0.22,2,2,2,2,0,0,0,0
30,116,1,65,65,65,65,0,0,0,0
31,6,1,30,30,30,30,0,0,0,0
31,8,0.25,18,18,18,18,0,0,0,0
31,9,2.75,382,382,382,382,0,0,0,0
31,12,1,50,50,50,50,0,0,0,0
31,14,1,13,13,13,13,0,0,0,0
31,17,0.81,63,63,63,63,0,0,0,0
31,22,0.71,20,20,20,20,0,0,0,0
31,23,2.59,452,452,452,452,0,0,0,0
31,25,1.32,484,484,484,484,0,0,0,0
31,26,0.68,357,357,357,357,0,0,0,0
31,27,0.76,165,165,165,165,0,0,0,0
31,28,5.24,1020,1020,1020,1020,0,0,0,0
31,29,0.33,227,227,227,227,0,0,0,0
31,30,0.42,294,294,294,294,0,0,0,0
31,56,1,8,8,8,8,0,0,0,0
31,57,2.56,1986,1986,1986,1986,0,0,0,0
31,58,0.95,308,308,308,308,0,0,0,0
31,61,1,186,186,186,186,0,0,0,0
31,62,2.02,326,326,326,326,0,0,0,0
31,63,8.03,1219,1219,1197,1197,23,23,0,0
31,64,5.71,625,625,350,350,275,275,0,0
31,65,1.89,218,218,218,218,0,0,0,0
31,68,0.02,4,4,4,4,0,0,0,0
31,69,11.46,1038,1038,1038,1038,0,0,0,0
31,78,3,158,158,158,158,0,0,0,0
31,79,2,156,156,156,156,0,0,0,0
31,88,0.38,148,148,148,148,0,0,0,0
31,89,1.27,109,109,109,109,0,0,0,0
31,92,2,325,325,325,325,0,0,0,0
31,93,1,139,139,139,139,0,0,0,0
31,99,1,24,24,24,24,0,0,0,0
31,100,1,14,14,14,14,0,0,0,0
32,12,0.45,6,6,6,6,0,0,0,0
32,13,0.55,8,8,8,8,0,0,0,0
32,17,0.19,15,15,15,15,0,0,0,0
32,21,1.07,57,57,57,57,0,0,0,0
32,22,0.26,23,23,23,23,0,0,0,0
32,23,4.44,468,468,468,468,0,0,0,0
32,25,0.44,159,159,159,159,0,0,0,0
32,26,0.56,207,207,207,207,0,0,0,0
32,55,1,63,63,63,63,0,0,0,0
32,57,0.18,64,64,64,64,0,0,0,0
32,62,10.72,1617,1617,1617,1617,0,0,0,0
32,63,6.74,1318,1318,1318,1318,0,0,0,0
32,64,7.56,1726,1726,1726,1726,0,0,0,0
32,65,2.94,471,471,471,471,0,0,0,0
32,66,6.7,817,817,817,817,0,0,0,0
32,67,4.53,648,648,648,648,0,0,0,0
32,68,5.85,1170,1170,1170,1170,0,0,0,0
32,69,5.95,772,772,772,772,0,0,0,0
32,70,2.29,490,490,490,490,0,0,0,0
32,71,7.56,799,799,799,799,0,0,0,0
32,72,4.55,716,716,716,716,0,0,0,0
32,73,9.1,872,872,872,872,0,0,0,0
32,74,2.78,286,286,286,286,0,0,0,0
32,75,6.77,679,679,679,679,0,0,0,0
32,76,18.73,1448,1448,1448,1448,0,0,0,0
32,77,10.1,958,958,958,958,0,0,0,0
32,78,2,122,122,122,122,0,0,0,0
32,79,2,69,69,69,69,0,0,0,0
32,89,1,594,594,594,594,0,0,0,0
32,100,1,87,87,87,87,0,0,0,0
32,102,2,154,154,154,154,0,0,0,0
33,8,2,110,110,110,110,0,0,0,0
33,9,1,64,64,64,64,0,0,0,0
33,20,1,42,42,42,42,0,0,0,0
33,21,1.93,359,359,359,359,0,0,0,0
33,59,0.82,227,227,227,227,0,0,0,0
33,61,10.48,1294,1294,1294,1294,0,0,0,0
33,62,3.33,351,351,351,351,0,0,0,0
33,63,0.02,0,0,0,0,0,0,0,0
33,65,5.37,897,897,897,897,0,0,0,0
33,66,5.94,1050,1050,1050,1050,0,0,0,0
33,67,4.95,2846,2846,2846,2846,0,0,0,0
33,68,8.34,864,864,864,864,0,0,0,0
33,69,11.7,1503,1503,1503,1503,0,0,0,0
33,70,25.92,1969,1969,1969,1969,0,0,0,0
33,71,3.12,669,669,669,669,0,0,0,0
33,72,1.27,266,266,266,266,0,0,0,0
33,73,14.99,1598,1598,1598,1598,0,0,0,0
33,74,36.88,2851,2851,2851,2851,0,0,0,0
33,75,18.67,2088,2088,2088,2088,0,0,0,0
33,76,12.72,1298,1298,1298,1298,0,0,0,0
33,92,1,3,3,3,3,0,0,0,0
33,93,1,5,5,5,5,0,0,0,0
33,119,0.69,13,13,13,13,0,0,0,0
34,7,3.96,1158,1158,1158,1158,0,0,0,0
34,8,0.46,25,25,25,25,0,0,0,0
34,9,1.58,85,85,85,85,0,0,0,0
34,17,1,26,26,26,26,0,0,0,0
34,18,1,268,268,268,268,0,0,0,0
34,20,4,224,224,224,224,0,0,0,0
34,22,0.8,73,73,73,73,0,0,0,0
34,59,2.19,406,406,406,406,0,0,0,0
34,60,2.78,524,524,524,524,0,0,0,0
34,61,6.57,466,466,466,466,0,0,0,0
34,62,3.08,220,220,220,220,0,0,0,0
34,64,0.1,17,17,17,17,0,0,0,0
34,65,0.87,114,114,114,114,0,0,0,0
34,66,0.22,27,27,27,27,0,0,0,0
34,67,1.71,203,203,203,203,0,0,0,0
34,68,1,216,216,216,216,0,0,0,0
34,70,1,244,244,0,0,244,244,0,0
34,71,0.08,8,8,8,8,0,0,0,0
34,72,5.26,1041,1041,1041,1041,0,0,0,0
34,73,12.18,1752,1752,1752,1752,0,0,0,0
34,74,4.7,335,335,335,335,0,0,0,0
34,76,2,2,2,2,2,0,0,0,0
34,77,1,3,3,3,3,0,0,0,0
34,78,1,214,214,214,214,0,0,0,0
34,98,1.02,25,25,25,25,0,0,0,0
34,99,2.98,161,161,161,161,0,0,0,0
34,115,1,16,16,16,16,0,0,0,0
34,117,1,36,36,36,36,0,0,0,0
34,118,1,12,12,12,12,0,0,0,0
34,119,0.31,6,6,6,6,0,0,0,0
35,14,0.49,13,13,0,0,13,13,0,0
35,15,0.51,14,14,0,0,14,14,0,0
35,18,2,211,211,211,211,0,0,0,0
35,19,2,204,204,204,204,0,0,0,0
35,20,3,134,134,134,134,0,0,0,0
35,22,0.2,18,18,18,18,0,0,0,0
35,48,1,37,37,37,37,0,0,0,0
35,60,0.21,24,24,24,24,0,0,0,0
35,61,6.45,523,523,523,523,0,0,0,0
35,62,8.81,1191,1191,1191,1191,0,0,0,0
35,63,4.28,463,463,463,463,0,0,0,0
35,64,5.57,1071,1071,1071,1071,0,0,0,0
35,65,9.52,1532,1532,1532,1532,0,0,0,0
35,66,5.24,1021,1021,1021,1021,0,0,0,0
35,67,2.18,74,74,74,74,0,0,0,0
35,68,0.08,16,16,16,16,0,0,0,0
35,69,0.81,164,164,164,164,0,0,0,0
35,71,3.02,386,386,386,386,0,0,0,0
35,72,4.31,585,585,585,585,0,0,0,0
35,73,2.94,468,468,468,468,0,0,0,0
35,74,4.09,110,110,110,110,0,0,0,0
35,76,4,6,6,6,6,0,0,0,0
35,93,1,9,9,9,9,0,0,0,0
35,111,1,16,16,16,16,0,0,0,0
35,115,1,9,9,9,9,0,0,0,0
35,116,2,49,49,49,49,0,0,0,0
36,6,1.01,48,48,45,45,3,3,0,0
36,7,0.99,213,213,0,0,213,213,0,0
36,8,1,303,303,303,303,0,0,0,0
36,10,1,48,48,0,0,48,48,0,0
36,19,0.29,74,74,74,74,0,0,0,0
36,20,2.71,315,315,315,315,0,0,0,0
36,22,1,190,190,190,190,0,0,0,0
36,61,1.01,275,275,275,275,0,0,0,0
36,62,2.04,485,485,485,485,0,0,0,0
36,63,2.34,230,230,230,230,0,0,0,0
36,64,11.35,1673,1673,1673,1673,0,0,0,0
36,65,6.53,1223,1223,1223,1223,0,0,0,0
36,66,6.97,854,854,854,854,0,0,0,0
36,67,13.25,1851,1851,1851,1851,0,0,0,0
36,68,1.8,446,446,446,446,0,0,0,0
36,69,0.58,215,215,215,215,0,0,0,0
36,72,0.33,44,44,44,44,0,0,0,0
36,73,0.97,3,3,3,3,0,0,0,0
36,77,5.12,368,368,368,368,0,0,0,0
36,78,1.7,350,350,350,350,0,0,0,0
36,82,1.61,160,160,160,160,0,0,0,0
36,83,4.39,369,369,369,369,0,0,0,0
36,91,1,4,4,4,4,0,0,0,0
36,101,2,184,184,184,184,0,0,0,0
36,113,0.59,29,29,29,29,0,0,0,0
36,114,0.41,20,20,20,20,0,0,0,0
37,4,2,91,91,91,91,0,0,0,0
37,6,2.95,165,165,165,165,0,0,0,0
37,7,2.08,415,415,415,415,0,0,0,0
37,15,0.98,331,331,0,0,331,331,0,0
37,63,1.12,227,227,227,227,0,0,0,0
37,64,7.04,1750,1750,1750,1750,0,0,0,0
37,65,6.05,1269,1269,1269,1269,0,0,0,0
37,66,2,271,271,271,271,0,0,0,0
37,68,2,29,29,29,29,0,0,0,0
37,69,2,322,322,322,322,0,0,0,0
37,77,8.93,739,739,739,739,0,0,0,0
37,78,4.26,478,478,478,478,0,0,0,0
37,84,1,61,61,61,61,0,0,0,0
37,92,2,34,34,34,34,0,0,0,0
37,95,3,146,146,146,146,0,0,0,0
37,99,1,18,18,18,18,0,0,0,0
38,4,1,33,33,33,33,0,0,0,0
38,6,1.97,92,92,92,92,0,0,0,0
38,8,0.34,205,205,205,205,0,0,0,0
38,10,1,29,29,29,29,0,0,0,0
38,14,2.28,363,363,0,0,363,363,0,0
38,15,1.84,1158,1158,0,0,1158,1158,0,0
38,17,1,78,78,78,78,0,0,0,0
38,18,1,309,309,309,309,0,0,0,0
38,63,0.51,121,121,121,121,0,0,0,0
38,64,3.49,877,877,877,877,0,0,0,0
38,65,7.35,1022,1022,1022,1022,0,0,0,0
38,68,1,31,31,31,31,0,0,0,0
38,97,1,16,16,16,16,0,0,0,0
39,3,1.43,72,72,72,72,0,0,0,0
39,4,3.57,341,341,341,341,0,0,0,0
39,7,2,547,547,383,383,164,164,0,0
39,8,0.66,402,402,402,402,0,0,0,0
39,9,2,45,45,45,45,0,0,0,0
39,13,1,18,18,18,18,0,0,0,0
39,14,2.89,305,305,54,54,250,250,0,0
39,15,0.02,18,18,0,0,18,18,0,0
39,16,1,33,33,33,33,0,0,0,0
39,17,1,37,37,37,37,0,0,0,0
39,50,8.79,589,589,589,589,0,0,0,0
39,51,2.66,195,195,195,195,0,0,0,0
39,52,1,55,55,55,55,0,0,0,0
39,63,2,414,414,414,414,0,0,0,0
39,64,2.25,240,240,240,240,0,0,0,0
39,65,0.01,1,1,1,1,0,0,0,0
39,66,1,23,23,23,23,0,0,0,0
39,78,2,44,44,44,44,0,0,0,0
40,2,1,432,432,432,432,0,0,0,0
40,3,0.02,5,5,5,5,0,0,0,0
40,4,4.05,503,503,503,503,0,0,0,0
40,8,1.67,222,222,222,222,0,0,0,0
40,9,4.48,733,733,733,733,0,0,0,0
40,10,0.75,102,102,102,102,0,0,0,0
40,12,1.28,268,268,268,268,0,0,0,0
40,13,2.72,631,631,631,631,0,0,0,0
40,16,1,81,81,81,81,0,0,0,0
40,49,2,247,247,247,247,0,0,0,0
40,50,0.98,59,59,59,59,0,0,0,0
40,51,4.23,269,269,269,269,0,0,0,0
40,61,1,44,44,44,44,0,0,0,0
40,62,2.8,555,555,555,555,0,0,0,0
40,63,0.94,212,212,212,212,0,0,0,0
40,64,2.25,3075,3075,0,0,3075,3075,0,0
40,65,1.53,1049,1049,0,0,1049,1049,0,0
40,66,1,36,36,36,36,0,0,0,0
40,67,0.02,2,2,2,2,0,0,0,0
40,71,1,10,10,10,10,0,0,0,0
40,97,2,221,221,221,221,0,0,0,0
40,98,1,29,29,29,29,0,0,0,0
40,109,3.99,554,554,554,554,0,0,0,0
40,110,0.01,5,5,5,5,0,0,0,0
40,121,0.55,907,907,907,907,0,0,0,0
40,122,2.97,1198,1198,1198,1198,0,0,0,0
41,3,3,157,157,157,157,0,0,0,0
41,4,1.87,258,258,258,258,0,0,0,0
41,5,3.13,348,348,290,290,59,59,0,0
41,6,1,41,41,41,41,0,0,0,0
41,7,2.17,154,154,154,154,0,0,0,0
41,8,1.85,164,164,164,164,0,0,0,0
41,9,0.1,7,7,7,7,0,0,0,0
41,10,2,329,329,329,329,0,0,0,0
41,12,2,314,314,314,314,0,0,0,0
41,14,1,107,107,107,107,0,0,0,0
41,15,1,373,373,373,373,0,0,0,0
41,19,2,272,272,272,272,0,0,0,0
41,21,2,81,81,81,81,0,0,0,0
41,49,0.82,42,42,42,42,0,0,0,0
41,50,1.18,107,107,107,107,0,0,0,0
41,51,0.34,25,25,25,25,0,0,0,0
41,62,2.26,218,218,218,218,0,0,0,0
41,63,0.54,1891,1891,0,0,1891,1891,0,0
41,64,4.35,2303,2303,0,0,2303,2303,0,0
41,65,0.24,348,348,0,0,348,348,0,0
41,67,0.98,116,116,116,116,0,0,0,0
41,68,1,22,22,22,22,0,0,0,0
41,72,1,16,16,16,16,0,0,0,0
41,121,0.39,725,725,725,725,0,0,0,0
41,122,2.09,1128,1128,1128,1128,0,0,0,0
42,1,1,64,64,64,64,0,0,0,0
42,2,0.04,2,2,2,2,0,0,0,0
42,3,1,83,83,83,83,0,0,0,0
42,5,6.91,1959,1959,1180,1180,779,779,0,0
42,6,1.42,92,92,92,92,0,0,0,0
42,7,7.79,986,986,749,749,238,238,0,0
42,8,0.97,119,119,117,117,1,1,0,0
42,9,2.02,150,150,150,150,0,0,0,0
42,11,1,66,66,66,66,0,0,0,0
42,15,0.27,98,98,98,98,0,0,0,0
42,16,2,321,321,321,321,0,0,0,0
42,49,1,39,39,39,39,0,0,0,0
42,50,2,130,130,130,130,0,0,0,0
42,58,0.47,356,356,356,356,0,0,0,0
42,62,1,46,46,46,46,0,0,0,0
42,63,5.1,1091,1091,0,0,1091,1091,0,0
42,68,1,35,35,35,35,0,0,0,0
42,69,1,6,6,6,6,0,0,0,0
42,70,0.83,24,24,24,24,0,0,0,0
42,71,0.17,5,5,5,5,0,0,0,0
42,73,6,71,71,71,71,0,0,0,0
43,0,0.5,85,85,85,85,0,0,0,0
43,1,2,129,129,129,129,0,0,0,0
43,2,0.96,44,44,44,44,0,0,0,0
43,3,1,48,48,48,48,0,0,0,0
43,4,4,532,532,532,532,0,0,0,0
43,5,0.02,8,8,8,8,0,0,0,0
43,6,3.82,655,655,655,655,0,0,0,0
43,7,2.93,890,890,48,48,842,842,0,0
43,8,1.05,182,182,182,182,0,0,0,0
43,9,0.98,87,87,87,87,0,0,0,0
43,10,1,212,212,212,212,0,0,0,0
43,14,1.93,60,60,60,60,0,0,0,0
43,15,0.73,268,268,268,268,0,0,0,0
43,50,2,201,201,201,201,0,0,0,0
43,58,0.53,395,395,395,395,0,0,0,0
43,82,1,71,71,71,71,0,0,0,0
43,83,0.16,6,6,6,6,0,0,0,0
43,84,0.84,33,33,33,33,0,0,0,0
44,0,0.5,85,85,85,85,0,0,0,0
44,2,1,219,219,219,219,0,0,0,0
44,5,1,285,285,285,285,0,0,0,0
44,6,3,492,492,492,492,0,0,0,0
44,12,3,650,650,650,650,0,0,0,0
44,13,1.08,144,144,144,144,0,0,0,0
44,14,2.83,297,297,297,297,0,0,0,0
44,15,1.16,36,36,36,36,0,0,0,0
44,56,0.74,346,346,346,346,0,0,0,0
44,77,0.08,3,3,3,3,0,0,0,0
44,79,1,50,50,50,50,0,0,0,0
44,80,1,22,22,22,22,0,0,0,0
44,82,1,17,17,17,17,0,0,0,0
44,86,1,21,21,21,21,0,0,0,0
44,87,1,19,19,19,19,0,0,0,0
44,92,2,101,101,101,101,0,0,0,0
44,93,1,21,21,21,21,0,0,0,0
45,0,1,76,76,76,76,0,0,0,0
45,7,1.71,106,106,106,106,0,0,0,0
45,8,1.14,194,194,194,194,0,0,0,0
45,9,3,288,288,288,288,0,0,0,0
45,12,1.8,310,310,310,310,0,0,0,0
45,13,0.2,11,11,11,11,0,0,0,0
45,15,1,60,60,60,60,0,0,0,0
45,16,1,119,119,119,119,0,0,0,0
45,56,0.26,124,124,124,124,0,0,0,0
45,60,1,46,46,46,46,0,0,0,0
45,77,0.92,33,33,33,33,0,0,0,0
45,78,1,18,18,18,18,0,0,0,0
45,82,1.25,210,210,210,210,0,0,0,0
45,83,1,39,39,39,39,0,0,0,0
46,4,0.46,141,141,141,141,0,0,0,0
46,5,2.81,1328,1328,1328,1328,0,0,0,0
46,6,1,97,97,97,97,0,0,0,0
46,7,2.25,251,251,251,251,0,0,0,0
46,8,2.98,879,879,879,879,0,0,0,0
46,11,1.06,263,263,263,263,0,0,0,0
46,12,1,340,340,340,340,0,0,0,0
46,14,1,61,61,61,61,0,0,0,0
46,15,4,121,121,121,121,0,0,0,0
46,29,1,154,154,154,154,0,0,0,0
46,54,1,20,20,20,20,0,0,0,0
46,62,1,22,22,22,22,0,0,0,0
46,63,3,82,82,82,82,0,0,0,0
46,76,2.86,525,525,525,525,0,0,0,0
46,78,2,48,48,48,48,0,0,0,0
46,79,1,28,28,28,28,0,0,0,0
46,81,2,62,62,62,62,0,0,0,0
46,82,1.82,141,141,141,141,0,0,0,0
46,83,0.93,64,64,64,64,0,0,0,0
46,85,0.02,7,7,7,7,0,0,0,0
46,86,2.98,449,449,449,449,0,0,0,0
46,88,1,19,19,19,19,0,0,0,0
46,92,1,14,14,14,14,0,0,0,0
46,93,1,39,39,39,39,0,0,0,0
46,94,3,75,75,75,75,0,0,0,0
46,95,2,62,62,62,62,0,0,0,0
46,96,1,22,22,22,22,0,0,0,0
47,4,1.41,313,313,313,313,0,0,0,0
47,5,0.32,208,208,208,208,0,0,0,0
47,6,5,363,363,363,363,0,0,0,0
47,7,1.04,45,45,45,45,0,0,0,0
47,8,1.88,247,247,247,247,0,0,0,0
47,9,0.38,12,12,12,12,0,0,0,0
47,10,1.34,283,283,283,283,0,0,0,0
47,11,8.62,2596,2596,2596,2596,0,0,0,0
47,12,2.43,603,603,603,603,0,0,0,0
47,13,0.13,33,33,33,33,0,0,0,0
47,14,0.87,224,224,224,224,0,0,0,0
47,50,2.55,245,245,245,245,0,0,0,0
47,52,0.67,2121,2121,2121,2121,0,0,0,0
47,56,1.28,252,252,252,252,0,0,0,0
47,57,2.54,1208,1208,48,48,1159,1159,0,0
47,58,0.57,1214,1214,0,0,1214,1214,0,0
47,63,2.46,218,218,218,218,0,0,0,0
47,64,1,12,12,12,12,0,0,0,0
47,71,2,157,157,157,157,0,0,0,0
47,72,3,92,92,92,92,0,0,0,0
47,73,0.59,35,35,35,35,0,0,0,0
47,75,2.3,41,41,41,41,0,0,0,0
47,76,0.14,14,14,14,14,0,0,0,0
47,79,1,37,37,37,37,0,0,0,0
47,85,1,40,40,40,40,0,0,0,0
47,86,0.39,37,37,37,37,0,0,0,0
47,88,1,30,30,30,30,0,0,0,0
47,92,3.41,116,116,116,116,0,0,0,0
47,93,0.02,0,0,0,0,0,0,0,0
47,94,1,58,58,58,58,0,0,0,0
48,3,1,16,16,0,0,16,16,0,0
48,6,1.49,116,116,116,116,0,0,0,0
48,7,3.51,285,285,285,285,0,0,0,0
48,8,1,24,24,24,24,0,0,0,0
48,9,2.76,227,227,227,227,0,0,0,0
48,10,0.5,65,65,65,65,0,0,0,0
48,11,1.91,496,496,496,496,0,0,0,0
48,12,2,142,142,142,142,0,0,0,0
48,50,0.45,14,14,14,14,0,0,0,0
48,52,0.33,1064,1064,1064,1064,0,0,0,0
48,55,1,46,46,46,46,0,0,0,0
48,56,0.72,136,136,136,136,0,0,0,0
48,57,0.05,115,115,0,0,115,115,0,0
48,58,0.58,1279,1279,0,0,1279,1279,0,0
48,59,0.26,565,565,0,0,565,565,0,0
48,63,0.58,66,66,66,66,0,0,0,0
48,64,3.96,666,666,666,666,0,0,0,0
48,67,1.1,68,68,68,68,0,0,0,0
48,68,0.34,31,31,31,31,0,0,0,0
48,71,1,220,220,220,220,0,0,0,0
48,72,1.87,236,236,236,236,0,0,0,0
48,73,0.54,29,29,29,29,0,0,0,0
48,74,0.2,10,10,10,10,0,0,0,0
48,75,6.32,508,508,508,508,0,0,0,0
48,76,1.66,68,68,68,68,0,0,0,0
48,77,4.87,123,123,123,123,0,0,0,0
48,78,0.17,13,13,13,13,0,0,0,0
48,84,4,135,135,135,135,0,0,0,0
48,85,1,43,43,43,43,0,0,0,0
48,86,3.12,218,218,218,218,0,0,0,0
48,87,2.5,398,398,398,398,0,0,0,0
48,88,0.97,77,77,77,77,0,0,0,0
48,89,1,35,35,35,35,0,0,0,0
48,92,1.57,115,115,115,115,0,0,0,0
48,96,1,28,28,28,28,0,0,0,0
49,3,3.99,701,701,197,197,504,504,0,0
49,4,0.01,7,7,0,0,7,7,0,0
49,6,0.59,131,131,131,131,0,0,0,0
49,7,0.26,142,142,142,142,0,0,0,0
49,8,0.83,186,186,186,186,0,0,0,0
49,11,0.6,28,28,28,28,0,0,0,0
49,12,0.4,19,19,19,19,0,0,0,0
49,25,1,96,96,96,96,0,0,0,0
49,36,1.34,71,71,71,71,0,0,0,0
49,50,1.08,95,95,11,11,84,84,0,0
49,51,0.14,143,143,0,0,143,143,0,0
49,64,1.27,93,93,93,93,0,0,0,0
49,65,0.73,66,66,66,66,0,0,0,0
49,66,2.81,536,536,536,536,0,0,0,0
49,67,1.17,211,211,211,211,0,0,0,0
49,70,1.95,184,184,184,184,0,0,0,0
49,71,0.05,8,8,8,8,0,0,0,0
49,74,1.02,283,283,283,283,0,0,0,0
49,75,2.79,968,968,968,968,0,0,0,0
49,76,2.43,154,154,154,154,0,0,0,0
49,77,12.38,786,786,786,786,0,0,0,0
49,78,0.67,83,83,83,83,0,0,0,0
49,79,3,154,154,154,154,0,0,0,0
49,84,1,29,29,29,29,0,0,0,0
49,86,0.7,87,87,87,87,0,0,0,0
49,88,1.03,155,155,155,155,0,0,0,0
49,89,1,129,129,129,129,0,0,0,0
49,93,2,72,72,72,72,0,0,0,0
49,94,1,28,28,28,28,0,0,0,0
49,95,6,448,448,448,448,0,0,0,0
50,2,1,37,37,37,37,0,0,0,0
50,3,2.99,536,536,536,536,0,0,0,0
50,4,1.39,85,85,85,85,0,0,0,0
50,5,3,1200,1200,1200,1200,0,0,0,0
50,6,3.65,434,434,434,434,0,0,0,0
50,7,5.97,2318,2318,2318,2318,0,0,0,0
50,8,4.19,742,742,742,742,0,0,0,0
50,9,0.34,12,12,12,12,0,0,0,0
50,10,2,134,134,134,134,0,0,0,0
50,22,2,133,133,133,133,0,0,0,0
50,23,1,13,13,13,13,0,0,0,0
50,24,1,92,92,92,92,0,0,0,0
50,32,0.07,3,3,3,3,0,0,0,0
50,33,0.93,40,40,40,40,0,0,0,0
50,36,0.66,34,34,34,34,0,0,0,0
50,50,0.92,951,951,0,0,951,951,0,0
50,51,0.86,877,877,0,0,877,877,0,0
50,66,1.38,351,351,351,351,0,0,0,0
50,67,0.2,65,65,65,65,0,0,0,0
50,68,1,50,50,50,50,0,0,0,0
50,70,0.93,71,71,71,71,0,0,0,0
50,71,3.07,430,430,430,430,0,0,0,0
50,72,5.61,476,476,476,476,0,0,0,0
50,73,7.93,540,540,540,540,0,0,0,0
50,74,2.98,391,391,391,391,0,0,0,0
50,75,2.82,643,643,643,643,0,0,0,0
50,77,2.05,382,382,382,382,0,0,0,0
50,78,1.26,171,171,171,171,0,0,0,0
50,79,6.74,345,345,345,345,0,0,0,0
50,80,2,58,58,58,58,0,0,0,0
50,83,1,31,31,31,31,0,0,0,0
50,86,1.3,168,168,168,168,0,0,0,0
50,91,3,204,204,204,204,0,0,0,0
50,92,5.25,226,226,226,226,0,0,0,0
50,93,0.34,11,11,11,11,0,0,0,0
51,0,1,49,49,49,49,0,0,0,0
51,3,2.66,468,468,468,468,0,0,0,0
51,4,1.92,436,436,436,436,0,0,0,0
51,5,1.14,131,131,131,131,0,0,0,0
51,6,11.91,2949,2949,2949,2949,0,0,0,0
51,7,8.85,3100,3100,3100,3100,0,0,0,0
51,8,7.18,2503,2503,2112,2112,391,391,0,0
51,9,1.04,89,89,89,89,0,0,0,0
51,10,1,213,213,213,213,0,0,0,0
51,13,1,28,28,28,28,0,0,0,0
51,36,0.01,2,2,2,2,0,0,0,0
51,65,1,77,77,77,77,0,0,0,0
51,66,2,77,77,77,77,0,0,0,0
51,70,1,210,210,210,210,0,0,0,0
51,71,1.01,220,220,220,220,0,0,0,0
51,72,5.94,627,627,627,627,0,0,0,0
51,73,3.79,649,649,649,649,0,0,0,0
51,74,9.42,769,769,769,769,0,0,0,0
51,75,4.39,388,388,388,388,0,0,0,0
51,76,2,162,162,162,162,0,0,0,0
51,77,4.94,479,479,479,479,0,0,0,0
51,82,1,12,12,12,12,0,0,0,0
51,84,1,28,28,28,28,0,0,0,0
51,91,3,65,65,65,65,0,0,0,0
51,92,4.75,639,639,639,639,0,0,0,0
51,93,0.66,21,21,21,21,0,0,0,0
51,95,1.21,37,37,37,37,0,0,0,0
52,0,1,139,139,139,139,0,0,0,0
52,1,1.71,135,135,135,135,0,0,0,0
52,2,2,151,151,151,151,0,0,0,0
52,3,1.01,97,97,97,97,0,0,0,0
52,5,5.02,881,881,881,881,0,0,0,0
52,6,10.49,2797,2797,2797,2797,0,0,0,0
52,7,8.87,2534,2534,2262,2262,159,159,113,113
52,8,3.93,2295,2295,606,606,1690,1690,0,0
52,9,1.77,179,179,179,179,0,0,0,0
52,10,0.02,1,1,1,1,0,0,0,0
52,11,0.98,45,45,45,45,0,0,0,0
52,12,0.73,22,22,22,22,0,0,0,0
52,36,1.99,358,358,358,358,0,0,0,0
52,55,1,237,237,237,237,0,0,0,0
52,58,1,130,130,130,130,0,0,0,0
52,67,2,27,27,27,27,0,0,0,0
52,69,0.89,41,41,41,41,0,0,0,0
52,70,1,24,24,24,24,0,0,0,0
52,72,1.03,196,196,196,196,0,0,0,0
52,73,8.69,2475,2475,1620,1620,0,0,855,855
52,74,17.3,2528,2528,2301,2301,0,0,227,227
52,75,4.92,780,780,780,780,0,0,0,0
52,77,2,79,79,79,79,0,0,0,0
52,78,2,154,154,154,154,0,0,0,0
52,79,1.71,228,228,228,228,0,0,0,0
52,80,3.83,139,139,139,139,0,0,0,0
52,88,1,21,21,21,21,0,0,0,0
52,95,0.79,36,36,36,36,0,0,0,0
53,1,3.25,491,491,491,491,0,0,0,0
53,2,2.04,128,128,128,128,0,0,0,0
53,3,3.5,397,397,397,397,0,0,0,0
53,4,10.09,2064,2064,2064,2064,0,0,0,0
53,5,11.98,3459,3459,3459,3459,0,0,0,0
53,6,11.05,4332,4332,4332,4332,0,0,0,0
53,7,3.38,4771,4771,4137,4137,9,9,625,625
53,8,8.87,2448,2448,2173,2173,274,274,0,0
53,10,1.23,182,182,182,182,0,0,0,0
53,11,0.77,11,11,11,11,0,0,0,0
53,12,2.27,99,99,99,99,0,0,0,0
53,21,2.23,201,201,201,201,0,0,0,0
53,22,0.69,154,154,154,154,0,0,0,0
53,54,1,19,19,19,19,0,0,0,0
53,66,0.98,139,139,139,139,0,0,0,0
53,67,2.02,73,73,73,73,0,0,0,0
53,69,0.11,5,5,5,5,0,0,0,0
53,71,1.17,74,74,74,74,0,0,0,0
53,72,0.92,230,230,230,230,0,0,0,0
53,73,6.46,712,712,712,712,0,0,0,0
53,74,3.99,535,535,535,535,0,0,0,0
53,75,7.22,1292,1292,1292,1292,0,0,0,0
53,76,1.32,363,363,363,363,0,0,0,0
53,77,0.9,49,49,49,49,0,0,0,0
53,78,0.1,6,6,6,6,0,0,0,0
53,79,2.46,244,244,244,244,0,0,0,0
53,80,2,43,43,43,43,0,0,0,0
53,81,1,14,14,14,14,0,0,0,0
53,82,1,21,21,21,21,0,0,0,0
53,102,3,100,100,100,100,0,0,0,0
54,0,2.31,372,372,372,372,0,0,0,0
54,1,1,337,337,337,337,0,0,0,0
54,4,6.19,1095,1095,1095,1095,0,0,0,0
54,5,6.37,2539,2539,2539,2539,0,0,0,0
54,6,8.92,6406,6406,6401,6401,0,0,5,5
54,7,6.79,2471,2471,2159,2159,0,0,312,312
54,8,3.17,618,618,618,618,0,0,0,0
54,11,0.53,38,38,38,38,0,0,0,0
54,21,1.09,82,82,82,82,0,0,0,0
54,40,1,76,76,76,76,0,0,0,0
54,63,2,45,45,45,45,0,0,0,0
54,65,2,92,92,92,92,0,0,0,0
54,67,1,132,132,132,132,0,0,0,0
54,68,0.37,68,68,68,68,0,0,0,0
54,69,2.59,190,190,190,190,0,0,0,0
54,70,0.18,4,4,4,4,0,0,0,0
54,71,4.83,400,400,400,400,0,0,0,0
54,72,4.71,569,569,569,569,0,0,0,0
54,74,7,1054,1054,1054,1054,0,0,0,0
54,75,1.92,1049,1049,1049,1049,0,0,0,0
54,76,4.98,1077,1077,1077,1077,0,0,0,0
54,77,8.67,680,680,680,680,0,0,0,0
54,78,0.23,319,319,319,319,0,0,0,0
54,79,2,82,82,82,82,0,0,0,0
54,83,1,25,25,25,25,0,0,0,0
54,85,1,24,24,24,24,0,0,0,0
54,91,1,35,35,35,35,0,0,0,0
54,93,5,371,371,371,371,0,0,0,0
54,103,1,16,16,16,16,0,0,0,0
54,104,2,57,57,57,57,0,0,0,0
55,0,0.2,79,79,79,79,0,0,0,0
55,2,0.34,110,110,110,110,0,0,0,0
55,3,1.87,593,593,593,593,0,0,0,0
55,4,4.28,736,736,736,736,0,0,0,0
55,5,6.49,2524,2524,2524,2524,0,0,0,0
55,6,6.62,5826,5826,5826,5826,0,0,0,0
55,7,4.75,2278,2278,2278,2278,0,0,0,0
55,8,0.92,41,41,41,41,0,0,0,0
55,9,0.01,1,1,1,1,0,0,0,0
55,10,1,200,200,200,200,0,0,0,0
55,11,0.46,33,33,33,33,0,0,0,0
55,25,2,76,76,76,76,0,0,0,0
55,40,0.88,138,138,138,138,0,0,0,0
55,65,2,53,53,53,53,0,0,0,0
55,69,5.96,280,280,280,280,0,0,0,0
55,70,1,73,73,73,73,0,0,0,0
55,71,1,106,106,106,106,0,0,0,0
55,72,0.37,18,18,18,18,0,0,0,0
55,73,2,450,450,450,450,0,0,0,0
55,74,4,308,308,308,308,0,0,0,0
55,75,0.01,5,5,5,5,0,0,0,0
55,76,5.7,2687,2687,2687,2687,0,0,0,0
55,77,11.55,1774,1774,1774,1774,0,0,0,0
55,78,2.55,1616,1616,1616,1616,0,0,0,0
55,79,1,11,11,11,11,0,0,0,0
55,80,3,270,270,270,270,0,0,0,0
55,104,1,67,67,67,67,0,0,0,0
56,1,2.27,429,429,295,295,135,135,0,0
56,2,1.91,578,578,188,188,390,390,0,0
56,3,4.54,389,389,389,389,0,0,0,0
56,4,7.63,1828,1828,1828,1828,0,0,0,0
56,5,2.69,604,604,604,604,0,0,0,0
56,6,7.27,783,783,783,783,0,0,0,0
56,7,2.07,121,121,121,121,0,0,0,0
56,8,1.93,394,394,394,394,0,0,0,0
56,9,0.36,9,9,9,9,0,0,0,0
56,10,0.64,16,16,16,16,0,0,0,0
56,12,2,73,73,73,73,0,0,0,0
56,40,1.12,69,69,69,69,0,0,0,0
56,61,1,24,24,24,24,0,0,0,0
56,64,2,130,130,130,130,0,0,0,0
56,69,5.9,166,166,166,166,0,0,0,0
56,74,7,206,206,206,206,0,0,0,0
56,75,6.04,1043,1043,1043,1043,0,0,0,0
56,76,2.99,702,702,702,702,0,0,0,0
56,77,0.55,564,564,564,564,0,0,0,0
56,78,1.24,258,258,258,258,0,0,0,0
56,79,3.85,390,390,390,390,0,0,0,0
56,80,1.46,738,738,738,738,0,0,0,0
56,81,1,14,14,14,14,0,0,0,0
56,82,1,33,33,33,33,0,0,0,0
56,100,1,13,13,13,13,0,0,0,0
56,102,3.79,186,186,186,186,0,0,0,0
56,103,0.63,81,81,81,81,0,0,0,0
56,104,0.45,61,61,61,61,0,0,0,0
56,122,1,526,526,526,526,0,0,0,0
57,1,0.33,70,70,21,21,49,49,0,0
57,2,1.15,392,392,40,40,352,352,0,0
57,3,2,56,56,56,56,0,0,0,0
57,4,3.8,374,374,374,374,0,0,0,0
57,5,3.31,607,607,607,607,0,0,0,0
57,6,2.19,280,280,280,280,0,0,0,0
57,9,3,410,410,410,410,0,0,0,0
57,30,1,33,33,33,33,0,0,0,0
57,52,1,39,39,39,39,0,0,0,0
57,54,1.68,97,97,97,97,0,0,0,0
57,55,2.54,94,94,94,94,0,0,0,0
57,62,1.59,23,23,23,23,0,0,0,0
57,64,0.01,4,4,4,4,0,0,0,0
57,65,2.99,368,368,368,368,0,0,0,0
57,67,0.9,38,38,38,38,0,0,0,0
57,68,0.1,4,4,4,4,0,0,0,0
57,69,2,71,71,71,71,0,0,0,0
57,71,4.57,241,241,241,241,0,0,0,0
57,72,0.43,98,98,98,98,0,0,0,0
57,74,4.59,587,587,587,587,0,0,0,0
57,75,7.1,984,984,984,984,0,0,0,0
57,76,2.02,435,435,435,435,0,0,0,0
57,79,0.79,250,250,250,250,0,0,0,0
57,80,2.92,600,600,600,600,0,0,0,0
57,87,0.74,183,183,0,0,183,183,0,0
57,88,0.36,5570,5570,0,0,5570,5570,0,0
57,89,1.08,3474,3474,0,0,3474,3474,0,0
57,90,0.12,43,43,0,0,43,43,0,0
57,97,1,15,15,15,15,0,0,0,0
57,100,2,89,89,89,89,0,0,0,0
57,101,1,15,15,15,15,0,0,0,0
57,102,0.12,6,6,6,6,0,0,0,0
58,1,0.06,6,6,6,6,0,0,0,0
58,2,0.28,26,26,26,26,0,0,0,0
58,6,0.41,56,56,56,56,0,0,0,0
58,7,1.45,108,108,108,108,0,0,0,0
58,8,2,197,197,197,197,0,0,0,0
58,11,2,64,64,64,64,0,0,0,0
58,20,1,62,62,62,62,0,0,0,0
58,53,3,113,113,113,113,0,0,0,0
58,54,8.23,305,305,305,305,0,0,0,0
58,55,0.46,22,22,22,22,0,0,0,0
58,56,1,37,37,37,37,0,0,0,0
58,58,1,36,36,36,36,0,0,0,0
58,62,1.41,55,55,55,55,0,0,0,0
58,63,3.99,372,372,372,372,0,0,0,0
58,64,3.04,95,95,95,95,0,0,0,0
58,65,0.97,34,34,34,34,0,0,0,0
58,66,1,18,18,18,18,0,0,0,0
58,69,2,28,28,28,28,0,0,0,0
58,73,1,124,124,124,124,0,0,0,0
58,74,3,504,504,504,504,0,0,0,0
58,75,5.86,1052,1052,1052,1052,0,0,0,0
58,76,4.4,445,445,445,445,0,0,0,0
58,77,0.31,17,17,17,17,0,0,0,0
58,79,5.23,995,995,995,995,0,0,0,0
58,80,5.76,777,777,777,777,0,0,0,0
58,81,2,101,101,101,101,0,0,0,0
58,83,1,89,89,89,89,0,0,0,0
58,84,2,191,191,191,191,0,0,0,0
58,87,0.26,66,66,0,0,66,66,0,0
58,88,0.22,3429,3429,0,0,3429,3429,0,0
58,89,1.21,3413,3413,0,0,3413,3413,0,0
58,93,0.01,2,2,2,2,0,0,0,0
58,98,1,165,165,165,165,0,0,0,0
58,100,1,24,24,24,24,0,0,0,0
58,119,1,30,30,30,30,0,0,0,0
58,123,1.36,61,61,61,61,0,0,0,0
59,1,0.39,131,131,131,131,0,0,0,0
59,2,0.61,208,208,208,208,0,0,0,0
59,3,1,68,68,68,68,0,0,0,0
59,4,3,436,436,436,436,0,0,0,0
59,5,1,204,204,204,204,0,0,0,0
59,7,1.14,211,211,211,211,0,0,0,0
59,30,1,50,50,50,50,0,0,0,0
59,38,1,48,48,48,48,0,0,0,0
59,53,1,123,123,123,123,0,0,0,0
59,54,0.09,2,2,2,2,0,0,0,0
59,55,4,145,145,145,145,0,0,0,0
59,56,3.48,221,221,221,221,0,0,0,0
59,57,1.52,124,124,124,124,0,0,0,0
59,58,1.03,50,50,50,50,0,0,0,0
59,60,1,76,76,76,76,0,0,0,0
59,61,1,50,50,50,50,0,0,0,0
59,68,2,73,73,73,73,0,0,0,0
59,73,3,66,66,66,66,0,0,0,0
59,75,2,166,166,166,166,0,0,0,0
59,76,2,223,223,223,223,0,0,0,0
59,77,0.69,36,36,36,36,0,0,0,0
59,80,1,151,151,151,151,0,0,0,0
59,83,1.53,4146,4146,0,0,4146,4146,0,0
59,84,2.51,1667,1667,0,0,1667,1667,0,0
59,85,1.08,285,285,0,0,285,285,0,0
59,86,0.35,643,643,0,0,643,643,0,0
59,87,0.42,490,490,0,0,490,490,0,0
59,88,0.01,12,12,0,0,12,12,0,0
59,92,0.05,5,5,5,5,0,0,0,0
59,93,6.2,825,825,825,825,0,0,0,0
59,94,5.74,129,129,129,129,0,0,0,0
59,95,3,41,41,41,41,0,0,0,0
59,123,0.64,53,53,53,53,0,0,0,0
60,4,0.99,81,81,81,81,0,0,0,0
60,5,0.01,1,1,1,1,0,0,0,0
60,7,0.8,370,370,370,370,0,0,0,0
60,11,1,34,34,34,34,0,0,0,0
60,28,1,55,55,55,55,0,0,0,0
60,29,1,83,83,83,83,0,0,0,0
60,38,1,56,56,56,56,0,0,0,0
60,55,2,54,54,54,54,0,0,0,0
60,56,5.98,265,265,265,265,0,0,0,0
60,57,5.02,281,281,281,281,0,0,0,0
60,58,7.78,533,533,533,533,0,0,0,0
60,59,2,234,234,234,234,0,0,0,0
60,61,2,262,262,262,262,0,0,0,0
60,62,2,74,74,74,74,0,0,0,0
60,63,1,42,42,42,42,0,0,0,0
60,70,6,170,170,170,170,0,0,0,0
60,73,6.74,753,753,753,753,0,0,0,0
60,75,2.42,99,99,99,99,0,0,0,0
60,79,4.1,304,304,304,304,0,0,0,0
60,80,7.9,1740,1740,1740,1740,0,0,0,0
60,83,0.22,174,174,0,0,174,174,0,0
60,84,2.62,2456,2456,0,0,2456,2456,0,0
60,85,3,1219,1219,0,0,1219,1219,0,0
60,86,0.65,1203,1203,0,0,1203,1203,0,0
60,87,2.35,1802,1802,0,0,1802,1802,0,0
60,88,2.75,2194,2194,0,0,2194,2194,0,0
60,89,0.7,551,551,0,0,551,551,0,0
60,94,1,59,59,59,59,0,0,0,0
60,95,2,66,66,66,66,0,0,0,0
60,109,1,95,95,95,95,0,0,0,0
60,110,1,161,161,161,161,0,0,0,0
60,112,1,115,115,115,115,0,0,0,0
60,116,1,51,51,51,51,0,0,0,0
60,120,0.93,88,88,88,88,0,0,0,0
61,0,4,509,509,509,509,0,0,0,0
61,7,0.2,92,92,92,92,0,0,0,0
61,58,0.19,19,19,19,19,0,0,0,0
61,59,1,34,34,34,34,0,0,0,0
61,61,2.72,179,179,179,179,0,0,0,0
61,62,3.28,447,447,447,447,0,0,0,0
61,63,2,49,49,49,49,0,0,0,0
61,64,2.06,58,58,58,58,0,0,0,0
61,65,1,50,50,50,50,0,0,0,0
61,67,2,157,157,157,157,0,0,0,0
61,68,1.01,194,194,194,194,0,0,0,0
61,69,2.52,220,220,220,220,0,0,0,0
61,70,1.14,70,70,70,70,0,0,0,0
61,71,0.13,68,68,68,68,0,0,0,0
61,72,3.76,305,305,305,305,0,0,0,0
61,73,3.51,427,427,427,427,0,0,0,0
61,75,2.58,281,281,281,281,0,0,0,0
61,76,3,147,147,147,147,0,0,0,0
61,77,1,150,150,150,150,0,0,0,0
61,78,1,132,132,132,132,0,0,0,0
61,83,0.78,614,614,0,0,614,614,0,0
61,84,0.26,694,694,0,0,694,694,0,0
61,86,1,21,21,21,21,0,0,0,0
61,88,3.24,2799,2799,0,0,2799,2799,0,0
61,89,2.9,695,695,112,112,584,584,0,0
61,92,1,26,26,26,26,0,0,0,0
61,110,1,89,89,89,89,0,0,0,0
61,117,1,40,40,40,40,0,0,0,0
61,120,1.07,97,97,97,97,0,0,0,0
62,3,1,28,28,28,28,0,0,0,0
62,4,1,52,52,52,52,0,0,0,0
62,7,1,68,68,68,68,0,0,0,0
62,56,3,146,146,146,146,0,0,0,0
62,57,0.18,13,13,13,13,0,0,0,0
62,58,1,24,24,24,24,0,0,0,0
62,63,1,32,32,32,32,0,0,0,0
62,64,2.94,131,131,131,131,0,0,0,0
62,65,3,266,266,266,266,0,0,0,0
62,66,2,65,65,65,65,0,0,0,0
62,69,1.47,104,104,104,104,0,0,0,0
62,70,1.86,337,337,337,337,0,0,0,0
62,71,1.87,651,651,651,651,0,0,0,0
62,72,2,183,183,183,183,0,0,0,0
62,73,2.23,245,245,245,245,0,0,0,0
62,74,0.77,30,30,30,30,0,0,0,0
62,75,3,117,117,117,117,0,0,0,0
62,77,0.62,31,31,31,31,0,0,0,0
62,78,1,155,155,155,155,0,0,0,0
62,79,1.93,294,294,294,294,0,0,0,0
62,80,1.58,228,228,228,228,0,0,0,0
62,89,3.64,537,537,537,537,0,0,0,0
62,98,0.59,301,301,301,301,0,0,0,0
62,99,1.04,34,34,34,34,0,0,0,0
62,111,1.9,246,246,246,246,0,0,0,0
62,113,1,117,117,117,117,0,0,0,0
62,118,1,58,58,58,58,0,0,0,0
63,6,1,65,65,65,65,0,0,0,0
63,8,0.67,114,114,114,114,0,0,0,0
63,34,1,44,44,44,44,0,0,0,0
63,57,0.82,59,59,59,59,0,0,0,0
63,60,3.36,325,325,325,325,0,0,0,0
63,61,3.64,121,121,121,121,0,0,0,0
63,65,1,8,8,8,8,0,0,0,0
63,66,6.61,468,468,468,468,0,0,0,0
63,67,0.39,21,21,21,21,0,0,0,0
63,68,1,45,45,45,45,0,0,0,0
63,69,2,27,27,27,27,0,0,0,0
63,70,0.17,4,4,4,4,0,0,0,0
63,73,3.03,432,432,432,432,0,0,0,0
63,74,0.84,190,190,190,190,0,0,0,0
63,75,1,217,217,217,217,0,0,0,0
63,76,2,93,93,93,93,0,0,0,0
63,77,1.38,27,27,27,27,0,0,0,0
63,78,1.07,41,41,41,41,0,0,0,0
63,79,3.49,251,251,251,251,0,0,0,0
63,80,3,79,79,79,79,0,0,0,0
63,92,1,40,40,40,40,0,0,0,0
63,98,0.26,135,135,135,135,0,0,0,0
63,99,0.11,56,56,56,56,0,0,0,0
63,106,1.44,56,56,56,56,0,0,0,0
63,110,0.39,114,114,114,114,0,0,0,0
63,111,8.7,732,732,732,732,0,0,0,0
63,112,1,46,46,46,46,0,0,0,0
63,113,3,397,397,397,397,0,0,0,0
63,114,6.41,317,317,317,317,0,0,0,0
63,115,0.59,35,35,35,35,0,0,0,0
64,7,0.78,84,84,84,84,0,0,0,0
64,8,0.33,58,58,58,58,0,0,0,0
64,59,1,34,34,34,34,0,0,0,0
64,60,5,360,360,360,360,0,0,0,0
64,61,5.47,359,359,359,359,0,0,0,0
64,63,3,95,95,95,95,0,0,0,0
64,66,6,413,413,413,413,0,0,0,0
64,67,0.76,70,70,70,70,0,0,0,0
64,68,1,38,38,38,38,0,0,0,0
64,69,1,61,61,61,61,0,0,0,0
64,70,1.83,209,209,209,209,0,0,0,0
64,72,0.56,34,34,34,34,0,0,0,0
64,73,0.59,27,27,27,27,0,0,0,0
64,74,0.12,25,25,25,25,0,0,0,0
64,75,10.93,487,487,487,487,0,0,0,0
64,76,2.07,182,182,182,182,0,0,0,0
64,77,2,236,236,236,236,0,0,0,0
64,78,3.93,285,285,285,285,0,0,0,0
64,79,2.84,87,87,87,87,0,0,0,0
64,80,11.58,479,479,479,479,0,0,0,0
64,81,0.2,9,9,9,9,0,0,0,0
64,94,1,16,16,16,16,0,0,0,0
64,106,0.56,29,29,29,29,0,0,0,0
64,109,1,175,175,175,175,0,0,0,0
64,110,16.43,1384,1384,1384,1384,0,0,0,0
64,111,20.94,1605,1605,1605,1605,0,0,0,0
64,112,18.99,1452,1452,1452,1452,0,0,0,0
64,113,3,409,409,409,409,0,0,0,0
64,114,1.01,277,277,0,0,277,277,0,0
64,115,2,64,64,64,64,0,0,0,0
65,4,1,20,20,20,20,0,0,0,0
65,7,0.22,24,24,24,24,0,0,0,0
65,28,1,37,37,37,37,0,0,0,0
65,41,2,67,67,67,67,0,0,0,0
65,58,2,64,64,64,64,0,0,0,0
65,60,1,113,113,113,113,0,0,0,0
65,61,1.53,23,23,23,23,0,0,0,0
65,63,0.24,30,30,30,30,0,0,0,0
65,65,2.69,247,247,247,247,0,0,0,0
65,66,1.31,287,287,287,287,0,0,0,0
65,67,0.24,22,22,22,22,0,0,0,0
65,68,3.18,129,129,129,129,0,0,0,0
65,69,1.82,250,250,250,250,0,0,0,0
65,70,3,110,110,110,110,0,0,0,0
65,71,1.13,52,52,52,52,0,0,0,0
65,72,1.74,261,261,261,261,0,0,0,0
65,73,12.17,482,482,482,482,0,0,0,0
65,74,5.87,586,586,586,586,0,0,0,0
65,77,7,513,513,513,513,0,0,0,0
65,78,1,101,101,101,101,0,0,0,0
65,79,2.16,112,112,112,112,0,0,0,0
65,80,0.32,14,14,14,14,0,0,0,0
65,81,0.9,31,31,31,31,0,0,0,0
65,109,7.01,534,534,534,534,0,0,0,0
65,110,41.53,2033,2033,2033,2033,0,0,0,0
65,111,34.1,2364,2364,2364,2364,0,0,0,0
65,112,14.19,1563,1563,1386,1386,177,177,0,0
65,113,1,56,56,56,56,0,0,0,0
66,1,1,52,52,52,52,0,0,0,0
66,35,1,33,33,33,33,0,0,0,0
66,41,1,52,52,52,52,0,0,0,0
66,63,0.99,117,117,117,117,0,0,0,0
66,64,1.77,150,150,150,150,0,0,0,0
66,66,1,115,115,115,115,0,0,0,0
66,67,6,193,193,193,193,0,0,0,0
66,68,1,41,41,41,41,0,0,0,0
66,70,2,266,266,266,266,0,0,0,0
66,71,2,45,45,45,45,0,0,0,0
66,72,2.19,350,350,350,350,0,0,0,0
66,73,3.77,478,478,478,478,0,0,0,0
66,80,3,90,90,90,90,0,0,0,0
66,81,5,294,294,294,294,0,0,0,0
66,99,0.96,73,73,73,73,0,0,0,0
66,100,0.04,3,3,3,3,0,0,0,0
66,109,31.34,1818,1818,1818,1818,0,0,0,0
66,110,23.46,1773,1773,1773,1773,0,0,0,0
66,111,65.79,4017,4017,4017,4017,0,0,0,0
66,112,60.47,3625,3625,3247,3247,0,0,378,378
66,113,1.99,59,59,59,59,0,0,0,0
66,114,0.31,13,13,13,13,0,0,0,0
66,115,1.69,129,129,129,129,0,0,0,0
66,116,1,57,57,57,57,0,0,0,0
66,119,2,67,67,67,67,0,0,0,0
67,1,1,74,74,74,74,0,0,0,0
67,5,1,26,26,26,26,0,0,0,0
67,41,1,62,62,62,62,0,0,0,0
67,47,1,51,51,51,51,0,0,0,0
67,64,3.85,172,172,172,172,0,0,0,0
67,65,5.08,307,307,307,307,0,0,0,0
67,66,1,188,188,188,188,0,0,0,0
67,67,1.14,126,126,126,126,0,0,0,0
67,68,3.31,295,295,295,295,0,0,0,0
67,69,10.11,899,899,899,899,0,0,0,0
67,70,5.41,424,424,424,424,0,0,0,0
67,71,6.47,199,199,199,199,0,0,0,0
67,72,1.42,256,256,256,256,0,0,0,0
67,73,4,601,601,601,601,0,0,0,0
67,77,1.01,57,57,57,57,0,0,0,0
67,78,1,29,29,29,29,0,0,0,0
67,101,1,41,41,41,41,0,0,0,0
67,105,1,62,62,62,62,0,0,0,0
67,108,4.78,305,305,305,305,0,0,0,0
67,109,9.83,579,579,579,579,0,0,0,0
67,110,12,1322,1322,1322,1322,0,0,0,0
67,111,43.7,2458,2458,2458,2458,0,0,0,0
67,112,42.83,2082,2082,2082,2082,0,0,0,0
67,114,1,80,80,80,80,0,0,0,0
67,121,2,191,191,191,191,0,0,0,0
67,122,1.15,86,86,86,86,0,0,0,0
68,34,1,58,58,58,58,0,0,0,0
68,62,0.42,10,10,10,10,0,0,0,0
68,63,2.58,67,67,67,67,0,0,0,0
68,64,0.15,8,8,8,8,0,0,0,0
68,65,9.48,485,485,485,485,0,0,0,0
68,66,1,199,199,199,199,0,0,0,0
68,67,3,316,316,316,316,0,0,0,0
68,68,3.64,558,558,558,558,0,0,0,0
68,69,5.38,740,740,740,740,0,0,0,0
68,70,1,53,53,53,53,0,0,0,0
68,71,6.53,580,580,580,580,0,0,0,0
68,72,3.45,857,857,857,857,0,0,0,0
68,73,2.13,382,382,382,382,0,0,0,0
68,74,3.06,410,410,410,410,0,0,0,0
68,75,2,80,80,80,80,0,0,0,0
68,76,1,27,27,27,27,0,0,0,0
68,77,4.99,170,170,170,170,0,0,0,0
68,88,1,3,3,3,3,0,0,0,0
68,105,1,138,138,138,138,0,0,0,0
68,106,0.74,124,124,124,124,0,0,0,0
68,107,1.26,438,438,438,438,0,0,0,0
68,108,1,117,117,117,117,0,0,0,0
68,109,6.13,1023,1023,1023,1023,0,0,0,0
68,110,4.34,1291,1291,1291,1291,0,0,0,0
68,111,11.84,776,776,776,776,0,0,0,0
68,112,2.95,394,394,394,394,0,0,0,0
68,113,1.37,107,107,107,107,0,0,0,0
68,122,1.85,274,274,274,274,0,0,0,0
68,123,1,171,171,171,171,0,0,0,0
69,2,1,76,76,76,76,0,0,0,0
69,3,1,82,82,82,82,0,0,0,0
69,5,0.49,71,71,71,71,0,0,0,0
69,6,1,103,103,103,103,0,0,0,0
69,40,3,102,102,102,102,0,0,0,0
69,64,2.4,336,336,336,336,0,0,0,0
69,65,11.08,473,473,473,473,0,0,0,0
69,66,5.08,493,493,493,493,0,0,0,0
69,67,0.01,2,2,2,2,0,0,0,0
69,68,3.18,237,237,237,237,0,0,0,0
69,69,1,190,190,190,190,0,0,0,0
69,71,3.48,471,471,471,471,0,0,0,0
69,72,5.54,820,820,677,677,0,0,142,142
69,73,1,219,219,219,219,0,0,0,0
69,74,2.2,258,258,258,258,0,0,0,0
69,75,3.74,372,372,372,372,0,0,0,0
69,76,7.53,502,502,502,502,0,0,0,0
69,77,1.81,73,73,73,73,0,0,0,0
69,106,2.72,317,317,317,317,0,0,0,0
69,108,1.5,293,293,293,293,0,0,0,0
69,109,2.03,443,443,443,443,0,0,0,0
69,110,3.5,462,462,462,462,0,0,0,0
69,112,1,24,24,24,24,0,0,0,0
69,113,1.01,191,191,191,191,0,0,0,0
70,0,1.04,130,130,130,130,0,0,0,0
70,5,3.51,237,237,237,237,0,0,0,0
70,34,1,73,73,73,73,0,0,0,0
70,64,1.02,268,268,268,268,0,0,0,0
70,65,1.32,162,162,162,162,0,0,0,0
70,66,2.54,386,386,386,386,0,0,0,0
70,68,3.82,311,311,311,311,0,0,0,0
70,69,7.91,353,353,353,353,0,0,0,0
70,70,3.1,108,108,108,108,0,0,0,0
70,71,4.78,750,750,750,750,0,0,0,0
70,72,4.2,671,671,671,671,0,0,0,0
70,73,3.83,614,614,614,614,0,0,0,0
70,74,0.72,63,63,63,63,0,0,0,0
70,75,1,22,22,22,22,0,0,0,0
70,76,5.48,326,326,326,326,0,0,0,0
70,77,3.88,196,196,196,196,0,0,0,0
70,79,2,73,73,73,73,0,0,0,0
70,106,0.28,38,38,38,38,0,0,0,0
70,107,2,374,374,374,374,0,0,0,0
70,108,1.5,263,263,263,263,0,0,0,0
70,109,12.97,1610,1610,1610,1610,0,0,0,0
70,110,7.5,1279,1279,1279,1279,0,0,0,0
70,111,2,322,322,322,322,0,0,0,0
70,112,0.73,118,118,118,118,0,0,0,0
70,113,4.27,662,662,662,662,0,0,0,0
70,121,1,57,57,57,57,0,0,0,0
70,124,0.71,160,160,160,160,0,0,0,0
70,125,1.27,234,234,234,234,0,0,0,0
70,126,2.65,785,785,785,785,0,0,0,0
71,0,0.96,305,305,305,305,0,0,0,0
71,2,1,209,209,209,209,0,0,0,0
71,58,1,40,40,40,40,0,0,0,0
71,65,1,41,41,41,41,0,0,0,0
71,66,1,48,48,48,48,0,0,0,0
71,70,3.17,69,69,69,69,0,0,0,0
71,74,0.76,68,68,68,68,0,0,0,0
71,75,2.25,131,131,131,131,0,0,0,0
71,76,1,61,61,61,61,0,0,0,0
71,77,1.33,126,126,126,126,0,0,0,0
71,78,0.97,55,55,55,55,0,0,0,0
71,107,13.07,1112,1112,1000,1000,112,112,0,0
71,108,7.59,476,476,476,476,0,0,0,0
71,109,10.33,1066,1066,1066,1066,0,0,0,0
71,110,1.52,309,309,309,309,0,0,0,0
71,111,1.59,328,328,328,328,0,0,0,0
71,112,0.82,43,43,43,43,0,0,0,0
71,113,1.97,307,307,307,307,0,0,0,0
71,114,1.03,136,136,136,136,0,0,0,0
71,116,1,83,83,83,83,0,0,0,0
71,122,0.74,82,82,82,82,0,0,0,0
71,124,0.02,5,5,5,5,0,0,0,0
71,126,2.3,394,394,394,394,0,0,0,0
71,127,2,99,99,99,99,0,0,0,0
72,1,1,35,35,35,35,0,0,0,0
72,4,1,19,19,19,19,0,0,0,0
72,59,2,69,69,69,69,0,0,0,0
72,61,0.01,1,1,1,1,0,0,0,0
72,62,0.41,5,5,5,5,0,0,0,0
72,63,1.59,63,63,63,63,0,0,0,0
72,65,1,38,38,38,38,0,0,0,0
72,66,1,157,157,157,157,0,0,0,0
72,67,0.37,49,49,49,49,0,0,0,0
72,68,0.73,46,46,46,46,0,0,0,0
72,75,0.27,12,12,12,12,0,0,0,0
72,77,2,81,81,81,81,0,0,0,0
72,78,1,48,48,48,48,0,0,0,0
72,102,1,44,44,44,44,0,0,0,0
72,108,6.56,579,579,579,579,0,0,0,0
72,109,1.84,248,248,248,248,0,0,0,0
72,111,2.82,568,568,568,568,0,0,0,0
72,112,0.84,116,116,116,116,0,0,0,0
72,113,1.18,201,201,201,201,0,0,0,0
72,114,4,457,457,457,457,0,0,0,0
72,122,1.26,394,394,394,394,0,0,0,0
72,126,0.04,1,1,1,1,0,0,0,0
73,1,1,250,250,250,250,0,0,0,0
73,29,0.02,3,3,3,3,0,0,0,0
73,30,5.98,635,635,635,635,0,0,0,0
73,31,0.35,40,40,40,40,0,0,0,0
73,32,0.65,73,73,73,73,0,0,0,0
73,61,1.99,62,62,62,62,0,0,0,0
73,62,3,131,131,131,131,0,0,0,0
73,66,4,207,207,207,207,0,0,0,0
73,67,10.65,1612,1612,1612,1612,0,0,0,0
73,68,24.92,2488,2488,2488,2488,0,0,0,0
73,69,16.45,1320,1320,1320,1320,0,0,0,0
73,70,0.85,30,30,30,30,0,0,0,0
73,72,1,33,33,33,33,0,0,0,0
73,79,3,107,107,107,107,0,0,0,0
73,105,0.55,18,18,18,18,0,0,0,0
73,106,0.81,27,27,27,27,0,0,0,0
73,108,1.06,134,134,134,134,0,0,0,0
73,109,0.55,92,92,92,92,0,0,0,0
73,110,3,209,209,209,209,0,0,0,0
73,112,0.21,32,32,32,32,0,0,0,0
73,113,0.02,3,3,3,3,0,0,0,0
73,115,1,90,90,90,90,0,0,0,0
73,121,2,71,71,71,71,0,0,0,0
73,123,2,76,76,76,76,0,0,0,0
73,127,7.07,992,992,992,992,0,0,0,0
74,2,3.73,930,930,930,930,0,0,0,0
74,3,4,430,430,430,430,0,0,0,0
74,31,3.09,397,397,397,397,0,0,0,0
74,32,4.23,368,368,368,368,0,0,0,0
74,34,1,41,41,41,41,0,0,0,0
74,62,2,69,69,69,69,0,0,0,0
74,66,4.44,284,284,284,284,0,0,0,0
74,67,38.28,3234,3234,3234,3234,0,0,0,0
74,68,112.95,6053,6053,6053,6053,0,0,0,0
74,69,53.48,2907,2907,2703,2703,0,0,205,205
74,70,3,543,543,543,543,0,0,0,0
74,72,2,72,72,72,72,0,0,0,0
74,76,4,109,109,109,109,0,0,0,0
74,78,1.95,44,44,44,44,0,0,0,0
74,79,2.05,74,74,74,74,0,0,0,0
74,105,0.64,22,22,22,22,0,0,0,0
74,109,0.07,63,63,63,63,0,0,0,0
74,110,6.57,1556,1556,1556,1556,0,0,0,0
74,111,5.72,800,800,800,800,0,0,0,0
74,112,0.99,223,223,223,223,0,0,0,0
74,123,1,27,27,27,27,0,0,0,0
74,124,1.69,163,163,163,163,0,0,0,0
74,127,2.23,150,150,150,150,0,0,0,0
75,2,1.3,169,169,169,169,0,0,0,0
75,3,0.97,218,218,218,218,0,0,0,0
75,32,8.96,1440,1440,1440,1440,0,0,0,0
75,33,9.64,1605,1605,1605,1605,0,0,0,0
75,34,0.31,35,35,35,35,0,0,0,0
75,35,1,27,27,27,27,0,0,0,0
75,38,5.08,591,591,591,591,0,0,0,0
75,39,1.88,122,122,122,122,0,0,0,0
75,65,0.68,24,24,24,24,0,0,0,0
75,66,0.46,41,41,41,41,0,0,0,0
75,67,83.34,4118,4118,4118,4118,0,0,0,0
75,68,137.37,6888,6888,6329,6329,141,141,418,418
75,69,22.05,1079,1079,1079,1079,0,0,0,0
75,72,2,95,95,95,95,0,0,0,0
75,77,1,29,29,29,29,0,0,0,0
75,104,0.01,0,0,0,0,0,0,0,0
75,109,3.8,346,346,346,346,0,0,0,0
75,110,0.84,113,113,113,113,0,0,0,0
75,111,1,223,223,223,223,0,0,0,0
75,112,1.01,106,106,106,106,0,0,0,0
75,117,1,20,20,20,20,0,0,0,0
75,123,1,173,173,173,173,0,0,0,0
75,124,2.31,483,483,483,483,0,0,0,0
75,125,1,158,158,158,158,0,0,0,0
75,126,2,82,82,82,82,0,0,0,0
75,127,0.4,83,83,83,83,0,0,0,0
76,1,1,23,23,23,23,0,0,0,0
76,32,6.87,764,764,764,764,0,0,0,0
76,33,6.37,922,922,922,922,0,0,0,0
76,34,2.39,257,257,257,257,0,0,0,0
76,35,1.86,724,724,724,724,0,0,0,0
76,36,1,90,90,90,90,0,0,0,0
76,37,2,284,284,284,284,0,0,0,0
76,38,7.04,853,853,853,853,0,0,0,0
76,62,1,107,107,107,107,0,0,0,0
76,65,2.47,35,35,35,35,0,0,0,0
76,66,5.54,488,488,488,488,0,0,0,0
76,67,76.66,5084,5084,5084,5084,0,0,0,0
76,68,44.47,3212,3212,3212,3212,0,0,856,856
76,69,0.13,17,17,17,17,0,0,0,0
76,71,1,40,40,40,40,0,0,0,0
76,75,2.13,61,61,61,61,0,0,0,0
76,76,4.87,101,101,101,101,0,0,0,0
76,79,7,158,158,158,158,0,0,0,0
76,104,0.99,51,51,51,51,0,0,0,0
76,111,0.97,428,428,0,0,428,428,0,0
76,114,0.04,8,8,8,8,0,0,0,0
76,115,1.71,207,207,207,207,0,0,0,0
76,116,1,183,183,183,183,0,0,0,0
76,124,2,67,67,67,67,0,0,0,0
76,125,1,204,204,204,204,0,0,0,0
76,126,1,178,178,178,178,0,0,0,0
76,127,0.6,124,124,124,124,0,0,0,0
77,0,1.02,199,199,199,199,0,0,0,0
77,1,1,131,131,131,131,0,0,0,0
77,32,2.42,170,170,170,170,0,0,0,0
77,34,0.85,323,323,323,323,0,0,0,0
77,35,1,137,137,137,137,0,0,0,0
77,36,8.35,1352,1352,1352,1352,0,0,0,0
77,37,1,61,61,61,61,0,0,0,0
77,61,1,39,39,39,39,0,0,0,0
77,62,1,57,57,57,57,0,0,0,0
77,63,2,51,51,51,51,0,0,0,0
77,65,2.65,135,135,135,135,0,0,0,0
77,66,12.55,701,701,701,701,0,0,0,0
77,67,57.94,3160,3160,3160,3160,0,0,0,0
77,68,32.01,1749,1749,1749,1749,0,0,0,0
77,71,2,61,61,61,61,0,0,0,0
77,72,0.49,39,39,39,39,0,0,0,0
77,73,1,33,33,33,33,0,0,0,0
77,75,1,87,87,87,87,0,0,0,0
77,76,1,42,42,42,42,0,0,0,0
77,111,1.91,1219,1219,0,0,1219,1219,0,0
77,112,4.4,1880,1880,0,0,1880,1880,0,0
77,113,2.01,901,901,0,0,901,901,0,0
77,115,0.26,36,36,36,36,0,0,0,0
77,126,1,155,155,155,155,0,0,0,0
78,0,0.98,226,226,226,226,0,0,0,0
78,1,2,125,125,125,125,0,0,0,0
78,3,1,99,99,99,99,0,0,0,0
78,36,5.93,620,620,620,620,0,0,0,0
78,37,3.36,644,644,644,644,0,0,0,0
78,65,16.59,1118,1118,1118,1118,0,0,0,0
78,66,83.98,3248,3248,3248,3248,0,0,0,0
78,67,55.2,2695,2695,2695,2695,0,0,0,0
78,68,7.83,1231,1231,1231,1231,0,0,0,0
78,69,1,27,27,27,27,0,0,0,0
78,70,1,38,38,38,38,0,0,0,0
78,72,2.51,103,103,103,103,0,0,0,0
78,73,2,55,55,55,55,0,0,0,0
78,76,2,89,89,89,89,0,0,0,0
78,107,1,82,82,82,82,0,0,0,0
78,111,0.11,87,87,0,0,87,87,0,0
78,112,2.96,3164,3164,0,0,3164,3164,0,0
78,113,1.37,1314,1314,0,0,1314,1314,0,0
78,114,2.65,2082,2082,0,0,2082,2082,0,0
78,115,0.84,663,663,0,0,663,663,0,0
79,28,0.45,10,10,10,10,0,0,0,0
79,37,5.36,558,558,558,558,0,0,0,0
79,38,2,129,129,129,129,0,0,0,0
79,65,3.31,118,118,118,118,0,0,0,0
79,66,0.6,27,27,27,27,0,0,0,0
79,67,5.53,168,168,168,168,0,0,0,0
79,68,4.38,571,571,571,571,0,0,0,0
79,69,7.88,973,973,973,973,0,0,0,0
79,70,0.27,49,49,49,49,0,0,0,0
79,76,2,61,61,61,61,0,0,0,0
79,112,0.2,378,378,0,0,378,378,0,0
79,113,0.11,205,205,0,0,205,205,0,0
79,115,2.88,2655,2655,133,133,2522,2522,0,0
79,116,1,18,18,18,18,0,0,0,0
79,124,1,127,127,127,127,0,0,0,0
80,28,2.55,277,277,277,277,0,0,0,0
80,34,1,167,167,167,167,0,0,0,0
80,38,1,204,204,204,204,0,0,0,0
80,61,0.17,7,7,7,7,0,0,0,0
80,62,1.83,77,77,77,77,0,0,0,0
80,63,0.26,18,18,18,18,0,0,0,0
80,64,0.74,53,53,53,53,0,0,0,0
80,67,2,45,45,45,45,0,0,0,0
80,68,1.93,304,304,304,304,0,0,0,0
80,69,1.07,71,71,71,71,0,0,0,0
80,106,0.67,61,61,61,61,0,0,0,0
80,110,1,25,25,25,25,0,0,0,0
80,113,0.38,2124,2124,0,0,2124,2124,0,0
80,115,0.59,3117,3117,0,0,3117,3117,0,0
80,122,1,114,114,114,114,0,0,0,0
80,123,1,28,28,28,28,0,0,0,0
80,125,2,133,133,133,133,0,0,0,0
80,127,1,124,124,124,124,0,0,0,0
81,0,2,86,86,86,86,0,0,0,0
81,28,1.98,163,163,163,163,0,0,0,0
81,29,0.02,0,0,0,0,0,0,0,0
81,35,2.76,383,383,383,383,0,0,0,0
81,36,5.24,738,738,738,738,0,0,0,0
81,64,1,26,26,26,26,0,0,0,0
81,65,2.75,121,121,121,121,0,0,0,0
81,66,2.48,110,110,110,110,0,0,0,0
81,67,1.77,248,248,248,248,0,0,0,0
81,72,2,447,447,447,447,0,0,0,0
81,104,1,25,25,25,25,0,0,0,0
81,106,0.33,30,30,30,30,0,0,0,0
81,113,1.32,5511,5511,0,0,5511,5511,0,0
81,114,2,1179,1179,0,0,1179,1179,0,0
81,122,1,22,22,22,22,0,0,0,0
81,123,2,61,61,61,61,0,0,0,0
81,124,2,67,67,67,67,0,0,0,0
82,2,1,22,22,22,22,0,0,0,0
82,3,3,161,161,161,161,0,0,0,0
82,35,0.25,35,35,35,35,0,0,0,0
82,36,1.76,331,331,331,331,0,0,0,0
82,46,5,139,139,139,139,0,0,0,0
82,63,6,270,270,270,270,0,0,0,0
82,68,0.1,78,78,78,78,0,0,0,0
82,69,0.44,360,360,360,360,0,0,0,0
82,79,1,43,43,43,43,0,0,0,0
82,111,1,39,39,39,39,0,0,0,0
82,113,0.24,690,690,0,0,690,690,0,0
82,114,0.07,150,150,0,0,150,150,0,0
82,123,3.62,274,274,274,274,0,0,0,0
82,124,0.48,22,22,22,22,0,0,0,0
82,125,1.4,47,47,47,47,0,0,0,0
82,126,0.33,29,29,29,29,0,0,0,0
82,127,1.2,152,152,152,152,0,0,0,0
83,0,1,19,19,19,19,0,0,0,0
83,3,1,30,30,30,30,0,0,0,0
83,34,7.1,846,846,499,499,347,347,0,0
83,35,3.29,555,555,407,407,148,148,0,0
83,36,3.1,402,402,402,402,0,0,0,0
83,63,2.78,96,96,96,96,0,0,0,0
83,64,1.22,54,54,54,54,0,0,0,0
83,68,0.2,162,162,162,162,0,0,0,0
83,69,0.27,218,218,218,218,0,0,0,0
83,76,1,14,14,14,14,0,0,0,0
83,114,0.1,701,701,0,0,701,701,0,0
83,120,1,37,37,37,37,0,0,0,0
83,123,0.38,27,27,27,27,0,0,0,0
83,125,2.13,52,52,52,52,0,0,0,0
83,126,3.6,379,379,379,379,0,0,0,0
83,127,0.8,82,82,82,82,0,0,0,0
84,0,0.65,89,89,89,89,0,0,0,0
84,34,3.3,226,226,226,226,0,0,0,0
84,35,7.93,1360,1360,1360,1360,0,0,0,0
84,36,2.34,152,152,152,152,0,0,0,0
84,63,1,32,32,32,32,0,0,0,0
84,64,1,59,59,59,59,0,0,0,0
84,66,1,59,59,59,59,0,0,0,0
84,114,0.85,5736,5736,0,0,5736,5736,0,0
84,115,0.96,467,467,180,180,287,287,0,0
84,116,0.08,16,16,16,16,0,0,0,0
84,123,1,25,25,25,25,0,0,0,0
84,124,1,92,92,92,92,0,0,0,0
84,126,1.54,240,240,240,240,0,0,0,0
84,127,0.52,113,113,113,113,0,0,0,0
85,34,0.16,4,4,4,4,0,0,0,0
85,35,8.63,1652,1652,1652,1652,0,0,0,0
85,36,3.13,229,229,229,229,0,0,0,0
85,41,1,59,59,59,59,0,0,0,0
85,44,1,70,70,70,70,0,0,0,0
85,63,1,62,62,62,62,0,0,0,0
85,64,3,132,132,132,132,0,0,0,0
85,68,1,23,23,23,23,0,0,0,0
85,73,1,15,15,15,15,0,0,0,0
85,75,2,64,64,64,64,0,0,0,0
85,114,1.04,739,739,0,0,739,739,0,0
85,115,0.58,2115,2115,0,0,2115,2115,0,0
85,120,0.01,1,1,1,1,0,0,0,0
85,123,1,60,60,60,60,0,0,0,0
85,126,0.1,4,4,4,4,0,0,0,0
85,127,0.9,39,39,39,39,0,0,0,0
86,30,1,45,45,45,45,0,0,0,0
86,35,1,345,345,345,345,0,0,0,0
86,37,1,57,57,57,57,0,0,0,0
86,43,1.35,53,53,53,53,0,0,0,0
86,44,1.65,84,84,84,84,0,0,0,0
86,46,1,13,13,13,13,0,0,0,0
86,66,1,8,8,8,8,0,0,0,0
86,112,1,19,19,19,19,0,0,0,0
86,115,0.97,2678,2678,0,0,2678,2678,0,0
86,116,0.03,72,72,0,0,72,72,0,0
86,120,0.99,58,58,58,58,0,0,0,0
86,123,1,40,40,40,40,0,0,0,0
86,127,3,460,460,460,460,0,0,0,0
87,21,1,75,75,75,75,0,0,0,0
87,55,1,19,19,19,19,0,0,0,0
87,62,3,99,99,99,99,0,0,0,0
87,69,1,19,19,19,19,0,0,0,0
87,93,1,11,11,11,11,0,0,0,0
87,113,0.89,564,564,564,564,0,0,0,0
87,114,1,32,32,32,32,0,0,0,0
87,115,1.78,1793,1793,0,0,1793,1793,0,0
87,116,0.59,639,639,0,0,639,639,0,0
87,117,2,1581,1581,0,0,1581,1581,0,0
87,123,1,114,114,114,114,0,0,0,0
87,125,2,32,32,32,32,0,0,0,0
88,10,1,33,33,33,33,0,0,0,0
88,28,1,101,101,101,101,0,0,0,0
88,43,1,52,52,52,52,0,0,0,0
88,69,1,34,34,34,34,0,0,0,0
88,113,0.11,70,70,70,70,0,0,0,0
88,114,4,620,620,620,620,0,0,0,0
88,125,2.98,78,78,78,78,0,0,0,0
88,126,0.02,1,1,1,1,0,0,0,0
89,39,1.38,84,84,84,84,0,0,0,0
89,40,0.62,135,135,135,135,0,0,0,0
89,115,0.23,34,34,34,34,0,0,0,0
89,116,0.77,114,114,114,114,0,0,0,0
89,122,1.01,80,80,80,80,0,0,0,0
89,124,1,31,31,31,31,0,0,0,0
89,125,1.71,53,53,53,53,0,0,0,0
89,126,9.29,295,295,295,295,0,0,0,0
90,39,1.62,439,439,439,439,0,0,0,0
90,59,1,38,38,38,38,0,0,0,0
90,94,1,25,25,25,25,0,0,0,0
90,110,24,763,763,763,763,0,0,0,0
90,115,4,133,133,133,133,0,0,0,0
90,116,2,302,302,302,302,0,0,0,0
90,122,0.71,29,29,29,29,0,0,0,0
90,123,0.28,11,11,11,11,0,0,0,0
90,125,1,60,60,60,60,0,0,0,0
90,126,3,63,63,63,63,0,0,0,0
90,127,2,362,362,362,362,0,0,0,0
91,39,0.38,226,226,226,226,0,0,0,0
91,55,1,43,43,43,43,0,0,0,0
91,70,1,15,15,15,15,0,0,0,0
91,116,0.64,284,284,284,284,0,0,0,0
91,117,2.36,363,363,363,363,0,0,0,0
91,120,1.06,55,55,55,55,0,0,0,0
91,127,1,85,85,85,85,0,0,0,0
92,63,1,7,7,7,7,0,0,0,0
92,110,1,28,28,28,28,0,0,0,0
92,111,2,49,49,49,49,0,0,0,0
92,120,0.94,33,33,33,33,0,0,0,0
92,122,1,186,186,186,186,0,0,0,0
92,127,1,31,31,31,31,0,0,0,0
93,60,1,17,17,17,17,0,0,0,0
93,62,1,15,15,15,15,0,0,0,0
93,93,3,82,82,82,82,0,0,0,0
93,110,2,34,34,34,34,0,0,0,0
93,117,0.94,1231,1231,1231,1231,0,0,0,0
93,118,3.06,124,124,124,124,0,0,0,0
93,119,1,789,789,789,789,0,0,0,0
93,120,1,43,43,43,43,0,0,0,0
93,122,2,78,78,78,78,0,0,0,0
94,26,0.61,33,33,33,33,0,0,0,0
94,27,0.39,21,21,21,21,0,0,0,0
94,70,1,23,23,23,23,0,0,0,0
94,111,4.71,643,643,643,643,0,0,0,0
94,112,1.52,282,282,282,282,0,0,0,0
94,116,1.58,164,164,164,164,0,0,0,0
94,117,3.42,292,292,292,292,0,0,0,0
94,118,1,242,242,242,242,0,0,0,0
94,119,1,300,300,300,300,0,0,0,0
94,120,4,211,211,211,211,0,0,0,0
94,121,1,63,63,63,63,0,0,0,0
94,122,2,433,433,433,433,0,0,0,0
94,125,1,18,18,18,18,0,0,0,0
95,15,1,49,49,49,49,0,0,0,0
95,94,0.42,8,8,8,8,0,0,0,0
95,111,14.18,1378,1378,1378,1378,0,0,0,0
95,112,6.43,520,520,520,520,0,0,0,0
95,117,0.89,192,192,192,192,0,0,0,0
95,118,2,222,222,222,222,0,0,0,0
95,119,0.89,41,41,41,41,0,0,0,0
95,120,1,63,63,63,63,0,0,0,0
95,121,1,100,100,100,100,0,0,0,0
96,15,0.72,19,19,19,19,0,0,0,0
96,16,0.28,7,7,7,7,0,0,0,0
96,69,1,19,19,19,19,0,0,0,0
96,71,1,27,27,27,27,0,0,0,0
96,94,2.58,72,72,72,72,0,0,0,0
96,109,3.42,359,359,359,359,0,0,0,0
96,110,20.32,1297,1297,1297,1297,0,0,0,0
96,111,31.64,2004,2004,2004,2004,0,0,0,0
96,112,8.64,699,699,699,699,0,0,0,0
96,114,3,63,63,63,63,0,0,0,0
96,117,0.11,25,25,25,25,0,0,0,0
96,119,0.11,5,5,5,5,0,0,0,0
96,120,1,9,9,9,9,0,0,0,0
96,123,1,47,47,47,47,0,0,0,0
96,124,0.38,37,37,37,37,0,0,0,0
96,125,3.62,328,328,328,328,0,0,0,0
97,59,1,14,14,14,14,0,0,0,0
97,92,1,18,18,18,18,0,0,0,0
97,109,12.58,1462,1462,1462,1462,0,0,0,0
97,110,7.72,1320,1320,1320,1320,0,0,0,0
97,111,8.19,891,891,891,891,0,0,0,0
97,112,10.81,743,743,743,743,0,0,0,0
97,115,0.03,4,4,4,4,0,0,0,0
97,117,0.43,632,632,632,632,0,0,0,0
97,118,0.57,830,830,830,830,0,0,0,0
97,126,1,73,73,73,73,0,0,0,0
98,38,1,30,30,30,30,0,0,0,0
98,63,1,25,25,25,25,0,0,0,0
98,109,12,754,754,754,754,0,0,0,0
98,110,6.23,488,488,488,488,0,0,0,0
98,111,10.48,636,636,636,636,0,0,0,0
98,115,0.97,142,142,142,142,0,0,0,0
98,116,1,75,75,75,75,0,0,0,0
98,117,3.22,414,414,414,414,0,0,0,0
98,118,1.17,246,246,246,246,0,0,0,0
98,119,0.61,281,281,281,281,0,0,0,0
98,123,1,54,54,54,54,0,0,0,0
98,127,2,93,93,93,93,0,0,0,0
99,60,1,66,66,66,66,0,0,0,0
99,87,1,16,16,16,16,0,0,0,0
99,101,0.36,11,11,11,11,0,0,0,0
99,107,1,8,8,8,8,0,0,0,0
99,109,5.91,880,880,880,880,0,0,0,0
99,110,10.77,785,785,785,785,0,0,0,0
99,114,2.91,280,280,280,280,0,0,0,0
99,115,2.46,244,244,244,244,0,0,0,0
99,116,1.54,226,226,226,226,0,0,0,0
99,117,0.1,16,16,16,16,0,0,0,0
99,118,4.01,745,745,745,745,0,0,0,0
99,119,1.01,30,30,30,30,0,0,0,0
99,123,1,147,147,147,147,0,0,0,0
99,126,1,54,54,54,54,0,0,0,0
99,127,1,188,188,188,188,0,0,0,0
100,63,1,14,14,14,14,0,0,0,0
100,94,1,20,20,20,20,0,0,0,0
100,97,1.23,48,48,48,48,0,0,0,0
100,98,4.77,125,125,125,125,0,0,0,0
100,101,1.64,33,33,33,33,0,0,0,0
100,108,1,135,135,135,135,0,0,0,0
100,109,2.44,96,96,96,96,0,0,0,0
100,114,0.1,13,13,13,13,0,0,0,0
100,115,2,177,177,177,177,0,0,0,0
100,118,3.61,1019,1019,1019,1019,0,0,0,0
100,119,1.39,497,497,497,497,0,0,0,0
100,120,1.07,491,491,491,491,0,0,0,0
100,121,0.41,330,330,330,330,0,0,0,0
100,122,0.28,82,82,82,82,0,0,0,0
100,123,1.45,722,722,722,722,0,0,0,0
100,124,0.07,10,10,10,10,0,0,0,0
101,33,1,31,31,31,31,0,0,0,0
101,58,1,7,7,7,7,0,0,0,0
101,96,1,27,27,27,27,0,0,0,0
101,98,1,21,21,21,21,0,0,0,0
101,112,2,57,57,57,57,0,0,0,0
101,114,1,208,208,208,208,0,0,0,0
101,116,1.4,187,187,187,187,0,0,0,0
101,118,0.89,47,47,47,47,0,0,0,0
101,119,1,315,315,315,315,0,0,0,0
101,120,2.29,527,527,527,527,0,0,0,0
101,121,1.22,1150,1150,1150,1150,0,0,0,0
101,122,0.1,101,101,101,101,0,0,0,0
101,123,1.21,203,203,203,203,0,0,0,0
101,124,0.93,134,134,134,134,0,0,0,0
101,126,1,37,37,37,37,0,0,0,0
102,37,1,59,59,59,59,0,0,0,0
102,38,1,34,34,34,34,0,0,0,0
102,60,1,20,20,20,20,0,0,0,0
102,99,4.95,193,193,193,193,0,0,0,0
102,100,1.72,37,37,37,37,0,0,0,0
102,106,4.89,111,111,0,0,111,111,0,0
102,115,0.35,34,34,34,34,0,0,0,0
102,116,2.25,195,195,195,195,0,0,0,0
102,117,0.33,66,66,66,66,0,0,0,0
102,118,0.65,82,82,82,82,0,0,0,0
102,119,0.85,187,187,187,187,0,0,0,0
102,120,0.49,138,138,138,138,0,0,0,0
102,121,0.06,8,8,8,8,0,0,0,0
102,122,0.71,2130,2130,2130,2130,0,0,0,0
102,123,1.26,884,884,884,884,0,0,0,0
102,126,1,50,50,50,50,0,0,0,0
103,9,1,41,41,41,41,0,0,0,0
103,58,1,47,47,47,47,0,0,0,0
103,89,1,17,17,17,17,0,0,0,0
103,98,1,27,27,27,27,0,0,0,0
103,99,0.34,19,19,19,19,0,0,0,0
103,100,2,45,45,45,45,0,0,0,0
103,105,0.01,2,2,0,0,2,2,0,0
103,106,1.1,274,274,0,0,274,274,0,0
103,113,3,174,174,174,174,0,0,0,0
103,114,3,297,297,297,297,0,0,0,0
103,116,1.88,940,940,940,940,0,0,0,0
103,117,2.48,1094,1094,1094,1094,0,0,0,0
103,118,0.02,4,4,4,4,0,0,0,0
103,119,0.99,128,128,128,128,0,0,0,0
103,121,1.94,165,165,165,165,0,0,0,0
103,122,1,92,92,92,92,0,0,0,0
103,124,1,21,21,21,21,0,0,0,0
104,35,1,15,15,15,15,0,0,0,0
104,37,1,69,69,69,69,0,0,0,0
104,58,1,54,54,54,54,0,0,0,0
104,79,1,38,38,38,38,0,0,0,0
104,82,1,11,11,11,11,0,0,0,0
104,86,1,18,18,18,18,0,0,0,0
104,96,1,17,17,17,17,0,0,0,0
104,97,7,188,188,188,188,0,0,0,0
104,98,3,64,64,64,64,0,0,0,0
104,106,2,55,55,55,55,0,0,0,0
104,107,12.78,988,988,988,988,0,0,0,0
104,108,1,60,60,60,60,0,0,0,0
104,110,1,54,54,54,54,0,0,0,0
104,111,4.81,387,387,387,387,0,0,0,0
104,112,8.27,781,781,781,781,0,0,0,0
104,113,0.7,81,81,81,81,0,0,0,0
104,114,1.3,206,206,206,206,0,0,0,0
104,115,2.99,463,463,463,463,0,0,0,0
104,116,0.15,129,129,129,129,0,0,0,0
104,117,0.15,131,131,131,131,0,0,0,0
104,119,0.01,2,2,2,2,0,0,0,0
104,120,5.01,301,301,301,301,0,0,0,0
104,126,2.2,266,266,266,266,0,0,0,0
104,127,0.8,75,75,75,75,0,0,0,0
105,6,0.76,29,29,29,29,0,0,0,0
105,24,1,32,32,32,32,0,0,0,0
105,25,1,38,38,38,38,0,0,0,0
105,79,5.88,201,201,201,201,0,0,0,0
105,80,1,21,21,21,21,0,0,0,0
105,86,1,18,18,18,18,0,0,0,0
105,97,1,14,14,14,14,0,0,0,0
105,98,1.97,66,66,66,66,0,0,0,0
105,99,4.8,166,166,166,166,0,0,0,0
105,106,1,16,16,16,16,0,0,0,0
105,107,1.22,225,225,225,225,0,0,0,0
105,108,1,193,193,193,193,0,0,0,0
105,109,1,94,94,94,94,0,0,0,0
105,110,3.74,188,188,188,188,0,0,0,0
105,111,19.39,981,981,981,981,0,0,0,0
105,112,0.8,140,140,140,140,0,0,0,0
105,114,0.5,86,86,86,86,0,0,0,0
105,116,1.64,85,85,85,85,0,0,0,0
105,117,2.27,381,381,381,381,0,0,0,0
105,118,2.53,250,250,250,250,0,0,0,0
105,119,0.67,120,120,120,120,0,0,0,0
105,120,5.33,424,424,424,424,0,0,0,0
105,121,1,42,42,42,42,0,0,0,0
105,122,2,38,38,38,38,0,0,0,0
105,123,1,31,31,31,31,0,0,0,0
105,124,1,119,119,119,119,0,0,0,0
106,6,0.24,9,9,9,9,0,0,0,0
106,34,1,30,30,30,30,0,0,0,0
106,79,1.12,48,48,48,48,0,0,0,0
106,80,2.39,57,57,57,57,0,0,0,0
106,84,1,12,12,12,12,0,0,0,0
106,99,0.23,6,6,6,6,0,0,0,0
106,105,2,263,263,263,263,0,0,0,0
106,106,1,121,121,121,121,0,0,0,0
106,107,1,20,20,20,20,0,0,0,0
106,108,2,47,47,47,47,0,0,0,0
106,109,1.07,166,166,166,166,0,0,0,0
106,110,4.93,430,430,430,430,0,0,0,0
106,111,6,755,755,755,755,0,0,0,0
106,113,1,30,30,30,30,0,0,0,0
106,114,0.5,86,86,86,86,0,0,0,0
106,115,1,131,131,131,131,0,0,0,0
106,116,3.7,599,599,599,599,0,0,0,0
106,117,3.73,352,352,352,352,0,0,0,0
106,118,0.47,85,85,85,85,0,0,0,0
106,119,1,615,615,615,615,0,0,0,0
107,8,1,90,90,90,90,0,0,0,0
107,9,1,25,25,25,25,0,0,0,0
107,80,1.61,15,15,15,15,0,0,0,0
107,81,0.44,18,18,18,18,0,0,0,0
107,105,1,21,21,21,21,0,0,0,0
107,106,0.92,28,28,28,28,0,0,0,0
107,108,0.08,11,11,11,11,0,0,0,0
107,109,0.96,132,132,132,132,0,0,0,0
107,110,13.85,879,879,879,879,0,0,0,0
107,111,10.71,840,840,840,840,0,0,0,0
107,113,1,11,11,11,11,0,0,0,0
107,114,2.3,238,238,238,238,0,0,0,0
107,115,3.31,321,321,321,321,0,0,0,0
107,116,1.67,304,304,304,304,0,0,0,0
108,30,1,53,53,53,53,0,0,0,0
108,80,2,42,42,42,42,0,0,0,0
108,81,0.56,22,22,22,22,0,0,0,0
108,99,1,16,16,16,16,0,0,0,0
108,105,1,16,16,16,16,0,0,0,0
108,106,1.08,33,33,33,33,0,0,0,0
108,108,0.34,6,6,6,6,0,0,0,0
108,109,2.02,376,376,376,376,0,0,0,0
108,110,7.14,1823,1823,1823,1823,0,0,0,0
108,111,3.28,318,318,318,318,0,0,0,0
108,112,10.42,1053,1053,1053,1053,0,0,0,0
108,113,10.19,537,537,537,537,0,0,0,0
108,114,11.18,1658,1658,1658,1658,0,0,0,0
108,115,6.11,1035,1035,1035,1035,0,0,0,0
108,116,1.3,66,66,66,66,0,0,0,0
108,117,0.03,6,6,6,6,0,0,0,0
108,118,1,38,38,38,38,0,0,0,0
109,8,1,146,146,146,146,0,0,0,0
109,9,1,62,62,62,62,0,0,0,0
109,31,0.01,0,0,0,0,0,0,0,0
109,32,2,90,90,90,90,0,0,0,0
109,33,1,87,87,87,87,0,0,0,0
109,57,2,32,32,32,32,0,0,0,0
109,94,1,22,22,22,22,0,0,0,0
109,102,2,22,22,22,22,0,0,0,0
109,104,3.15,102,102,102,102,0,0,0,0
109,105,1.24,165,165,165,165,0,0,0,0
109,106,4,202,202,202,202,0,0,0,0
109,107,1,30,30,30,30,0,0,0,0
109,110,2.48,328,328,328,328,0,0,0,0
109,111,14.33,1293,1293,1293,1293,0,0,0,0
109,112,5.15,1094,1094,1094,1094,0,0,0,0
109,113,6.18,407,407,188,188,219,219,0,0
109,114,1.23,127,127,127,127,0,0,0,0
109,115,1,29,29,29,29,0,0,0,0
109,116,0.69,146,146,146,146,0,0,0,0
109,117,0.08,16,16,16,16,0,0,0,0
110,8,1,77,77,77,77,0,0,0,0
110,9,1,67,67,67,67,0,0,0,0
110,10,1,40,40,40,40,0,0,0,0
110,31,1.99,129,129,129,129,0,0,0,0
110,50,1,14,14,14,14,0,0,0,0
110,57,3,85,85,85,85,0,0,0,0
110,76,2,70,70,70,70,0,0,0,0
110,92,0.19,5,5,5,5,0,0,0,0
110,93,2.06,115,115,115,115,0,0,0,0
110,94,0.56,169,169,169,169,0,0,0,0
110,95,0.92,26,26,26,26,0,0,0,0
110,96,1.08,21,21,21,21,0,0,0,0
110,99,1,143,143,143,143,0,0,0,0
110,102,2,70,70,70,70,0,0,0,0
110,103,2,314,314,314,314,0,0,0,0
110,104,3.61,335,335,335,335,0,0,0,0
110,107,1,31,31,31,31,0,0,0,0
110,109,2.41,374,374,374,374,0,0,0,0
110,110,6.59,343,343,343,343,0,0,0,0
110,111,2.36,156,156,156,156,0,0,0,0
110,112,9.89,1135,1135,1135,1135,0,0,0,0
110,113,3,640,640,640,640,0,0,0,0
110,114,3.77,502,502,502,502,0,0,0,0
110,115,0.79,69,69,69,69,0,0,0,0
110,116,2,186,186,186,186,0,0,0,0
110,117,1,133,133,133,133,0,0,0,0
110,123,0.15,284,284,0,0,284,284,0,0
110,124,2.58,1157,1157,0,0,1157,1157,0,0
110,125,0.25,57,57,0,0,57,57,0,0
110,126,2.4,290,290,0,0,290,290,0,0
111,6,1,100,100,100,100,0,0,0,0
111,7,1,164,164,164,164,0,0,0,0
111,8,1,174,174,0,0,174,174,0,0
111,9,0.17,53,53,53,53,0,0,0,0
111,29,1,116,116,116,116,0,0,0,0
111,57,1,16,16,16,16,0,0,0,0
111,79,1,12,12,12,12,0,0,0,0
111,91,0.36,69,69,69,69,0,0,0,0
111,92,1,42,42,42,42,0,0,0,0
111,93,2.63,457,457,55,55,403,403,0,0
111,94,5.11,626,626,626,626,0,0,0,0
111,95,8.06,206,206,206,206,0,0,0,0
111,96,3,58,58,58,58,0,0,0,0
111,98,0.29,6,6,6,6,0,0,0,0
111,99,1.71,66,66,66,66,0,0,0,0
111,100,4,92,92,92,92,0,0,0,0
111,103,1,31,31,31,31,0,0,0,0
111,105,0.53,22,22,22,22,0,0,0,0
111,106,2.47,93,93,93,93,0,0,0,0
111,107,2.13,89,89,89,89,0,0,0,0
111,108,12.2,770,770,770,770,0,0,0,0
111,109,4.07,221,221,221,221,0,0,0,0
111,110,1.3,389,389,389,389,0,0,0,0
111,111,12.32,940,940,940,940,0,0,0,0
111,112,6.28,241,241,241,241,0,0,0,0
111,113,2,37,37,37,37,0,0,0,0
111,115,2.21,215,215,215,215,0,0,0,0
111,117,5,259,259,259,259,0,0,0,0
111,123,0.68,1263,1263,0,0,1263,1263,0,0
111,124,2.52,2210,2210,0,0,2210,2210,0,0
111,125,4.89,2147,2147,0,0,2147,2147,0,0
111,126,1.82,155,155,0,0,155,155,0,0
112,6,1,55,55,55,55,0,0,0,0
112,9,4.83,704,704,704,704,0,0,0,0
112,51,1,14,14,14,14,0,0,0,0
112,57,4,125,125,125,125,0,0,0,0
112,65,1,35,35,35,35,0,0,0,0
112,91,4.85,725,725,725,725,0,0,0,0
112,92,18.4,1628,1628,1628,1628,0,0,0,0
112,93,10.98,1740,1740,1058,1058,682,682,0,0
112,94,48.91,2218,2218,2216,2216,1,1,0,0
112,95,18.31,1040,1040,1040,1040,0,0,0,0
112,96,0.52,190,190,190,190,0,0,0,0
112,100,1,106,106,106,106,0,0,0,0
112,101,1,36,36,36,36,0,0,0,0
112,104,1,77,77,77,77,0,0,0,0
112,105,1.83,217,217,217,217,0,0,0,0
112,106,3,204,204,204,204,0,0,0,0
112,107,3,380,380,380,380,0,0,0,0
112,108,4.73,512,512,512,512,0,0,0,0
112,109,3.81,629,629,629,629,0,0,0,0
112,110,1.72,506,506,506,506,0,0,0,0
112,111,4,200,200,200,200,0,0,0,0
112,112,28.37,1316,1316,1316,1316,0,0,0,0
112,115,1.99,167,167,167,167,0,0,0,0
112,116,3.09,696,696,696,696,0,0,0,0
112,117,8.04,752,752,752,752,0,0,0,0
112,118,11.38,584,584,584,584,0,0,0,0
112,119,0.25,43,43,43,43,0,0,0,0
112,123,3,1896,1896,0,0,1896,1896,0,0
112,124,4.1,1028,1028,0,0,1028,1028,0,0
112,125,2.6,3556,3556,0,0,3556,3556,0,0
112,126,2,256,256,175,175,80,80,0,0
112,127,1,297,297,297,297,0,0,0,0
113,17,0.81,18,18,18,18,0,0,0,0
113,29,3.23,261,261,261,261,0,0,0,0
113,30,1,114,114,114,114,0,0,0,0
113,58,1,53,53,53,53,0,0,0,0
113,71,1,25,25,25,25,0,0,0,0
113,86,1,34,34,34,34,0,0,0,0
113,87,2,35,35,35,35,0,0,0,0
113,88,1,73,73,73,73,0,0,0,0
113,90,1,47,47,47,47,0,0,0,0
113,91,9.15,962,962,962,962,0,0,0,0
113,92,27.22,1761,1761,1761,1761,0,0,0,0
113,93,68.55,3484,3484,3484,3484,0,0,0,0
113,94,81.4,3863,3863,3863,3863,0,0,0,0
113,95,146.08,5284,5284,5174,5174,0,0,110,110
113,96,34.33,1478,1478,1274,1274,0,0,205,205
113,99,3,180,180,180,180,0,0,0,0
113,100,1.26,20,20,20,20,0,0,0,0
113,101,1,74,74,74,74,0,0,0,0
113,102,3,129,129,129,129,0,0,0,0
113,103,3,122,122,122,122,0,0,0,0
113,104,1,122,122,122,122,0,0,0,0
113,105,1.26,163,163,163,163,0,0,0,0
113,106,0.91,136,136,136,136,0,0,0,0
113,108,0.14,30,30,30,30,0,0,0,0
113,109,1.75,1300,1300,1300,1300,0,0,0,0
113,111,4.75,228,228,228,228,0,0,0,0
113,112,1.9,42,42,42,42,0,0,0,0
113,114,1,11,11,11,11,0,0,0,0
113,115,3.69,718,718,718,718,0,0,0,0
113,116,5.48,1321,1321,1321,1321,0,0,0,0
113,117,12.81,1583,1583,1583,1583,0,0,0,0
113,118,10.67,916,916,916,916,0,0,0,0
113,119,2.16,285,285,285,285,0,0,0,0
113,120,2.36,166,166,166,166,0,0,0,0
113,121,0.64,54,54,54,54,0,0,0,0
113,124,2.06,66,66,44,44,22,22,0,0
113,125,1,60,60,60,60,0,0,0,0
114,3,1,13,13,13,13,0,0,0,0
114,17,0.19,4,4,4,4,0,0,0,0
114,21,0.11,21,21,21,21,0,0,0,0
114,22,4.89,415,415,415,415,0,0,0,0
114,29,0.77,119,119,119,119,0,0,0,0
114,52,1,14,14,14,14,0,0,0,0
114,59,1,23,23,23,23,0,0,0,0
114,63,3,521,521,521,521,0,0,0,0
114,90,2,86,86,86,86,0,0,0,0
114,91,0.58,87,87,87,87,0,0,0,0
114,92,6.42,254,254,254,254,0,0,0,0
114,94,1,29,29,29,29,0,0,0,0
114,95,23.48,882,882,875,875,0,0,7,7
114,96,41.82,1436,1436,1409,1409,0,0,27,27
114,98,1,8,8,8,8,0,0,0,0
114,100,4.74,93,93,93,93,0,0,0,0
114,101,3,66,66,66,66,0,0,0,0
114,102,1,14,14,14,14,0,0,0,0
114,105,1,26,26,26,26,0,0,0,0
114,106,1.28,54,54,54,54,0,0,0,0
114,107,2.72,137,137,137,137,0,0,0,0
114,109,0.14,230,230,230,230,0,0,0,0
114,111,0.41,36,36,36,36,0,0,0,0
114,112,1.32,255,255,255,255,0,0,0,0
114,113,0.69,87,87,87,87,0,0,0,0
114,114,1.31,177,177,177,177,0,0,0,0
114,116,3.5,1508,1508,1508,1508,0,0,0,0
114,117,7.01,947,947,947,947,0,0,0,0
114,118,2.92,337,337,337,337,0,0,0,0
114,121,0.8,181,181,181,181,0,0,0,0
114,122,0.2,46,46,46,46,0,0,0,0
114,123,2.4,363,363,363,363,0,0,0,0
114,124,2.21,366,366,366,366,0,0,0,0
114,125,0.73,209,209,209,209,0,0,0,0
115,3,1,80,80,80,80,0,0,0,0
115,16,1,7,7,7,7,0,0,0,0
115,18,1,68,68,68,68,0,0,0,0
115,21,2,215,215,215,215,0,0,0,0
115,22,1,36,36,36,36,0,0,0,0
115,49,6,202,202,202,202,0,0,0,0
115,61,1,67,67,67,67,0,0,0,0
115,63,3,64,64,64,64,0,0,0,0
115,64,2,307,307,307,307,0,0,0,0
115,87,2,357,357,357,357,0,0,0,0
115,99,1,27,27,27,27,0,0,0,0
115,100,1,52,52,52,52,0,0,0,0
115,102,2,80,80,80,80,0,0,0,0
115,111,0.59,51,51,51,51,0,0,0,0
115,112,0.68,223,223,223,223,0,0,0,0
115,114,1,37,37,37,37,0,0,0,0
115,122,1,65,65,65,65,0,0,0,0
115,123,0.6,96,96,96,96,0,0,0,0
115,124,2.77,320,320,320,320,0,0,0,0
115,126,4,211,211,211,211,0,0,0,0
115,127,7,345,345,345,345,0,0,0,0
116,3,1,101,101,101,101,0,0,0,0
116,4,0.55,19,19,19,19,0,0,0,0
116,5,1.93,126,126,126,126,0,0,0,0
116,10,1.38,120,120,120,120,0,0,0,0
116,18,2.26,172,172,172,172,0,0,0,0
116,22,1.86,253,253,253,253,0,0,0,0
116,23,0.05,2,2,2,2,0,0,0,0
116,53,1,14,14,14,14,0,0,0,0
116,60,5,266,266,266,266,0,0,0,0
116,62,0.81,127,127,127,127,0,0,0,0
116,63,0.1,15,15,15,15,0,0,0,0
116,65,1,113,113,113,113,0,0,0,0
116,72,1,18,18,18,18,0,0,0,0
116,82,1,14,14,14,14,0,0,0,0
116,84,1,27,27,27,27,0,0,0,0
116,86,0.67,42,42,42,42,0,0,0,0
116,97,2,60,60,60,60,0,0,0,0
116,115,0.02,1,1,1,1,0,0,0,0
116,116,1.39,296,296,296,296,0,0,0,0
116,117,1.12,702,702,702,702,0,0,0,0
116,118,0.9,37,37,37,37,0,0,0,0
116,119,0.1,4,4,4,4,0,0,0,0
116,120,0.05,8,8,8,8,0,0,0,0
116,121,2.23,531,531,531,531,0,0,0,0
116,122,2,100,100,100,100,0,0,0,0
116,123,1.03,17,17,17,17,0,0,0,0
116,124,3.61,313,313,313,313,0,0,0,0
116,127,0.9,115,115,115,115,0,0,0,0
117,4,2.61,465,465,465,465,0,0,0,0
117,5,2.75,668,668,668,668,0,0,0,0
117,6,3.14,501,501,501,501,0,0,0,0
117,8,1,406,406,0,0,406,406,0,0
117,9,0.97,260,260,77,77,183,183,0,0
117,10,1.94,219,219,87,87,132,132,0,0
117,14,0.27,32,32,32,32,0,0,0,0
117,15,6.73,704,704,659,659,45,45,0,0
117,16,0.61,181,181,181,181,0,0,0,0
117,18,2.74,225,225,225,225,0,0,0,0
117,20,3,297,297,297,297,0,0,0,0
117,21,0.85,22,22,22,22,0,0,0,0
117,22,1.29,55,55,55,55,0,0,0,0
117,23,1.95,80,80,80,80,0,0,0,0
117,62,2.71,136,136,136,136,0,0,0,0
117,63,7.38,305,305,305,305,0,0,0,0
117,64,0.03,1,1,1,1,0,0,0,0
117,65,1.97,78,78,78,78,0,0,0,0
117,66,1,23,23,23,23,0,0,0,0
117,80,2,41,41,41,41,0,0,0,0
117,81,1,24,24,24,24,0,0,0,0
117,86,0.33,20,20,20,20,0,0,0,0
117,116,0.39,296,296,296,296,0,0,0,0
117,117,0.09,70,70,70,70,0,0,0,0
117,119,4.01,1186,1186,1186,1186,0,0,0,0
117,120,1,117,117,117,117,0,0,0,0
117,121,2.72,274,274,274,274,0,0,0,0
117,123,0.96,1338,1338,1338,1338,0,0,0,0
117,124,2.69,201,201,201,201,0,0,0,0
117,125,0.33,96,96,96,96,0,0,0,0
117,127,0.1,12,12,12,12,0,0,0,0
118,4,5.48,984,984,984,984,0,0,0,0
118,5,9.5,2156,2156,2156,2156,0,0,0,0
118,6,2.87,316,316,316,316,0,0,0,0
118,7,2.09,419,419,419,419,0,0,0,0
118,8,5.06,1007,1007,1007,1007,0,0,0,0
118,9,4.72,584,584,584,584,0,0,0,0
118,10,0.86,8,8,0,0,8,8,0,0
118,11,1,37,37,37,37,0,0,0,0
118,12,3,346,346,174,174,172,172,0,0
118,13,1,275,275,275,275,0,0,0,0
118,14,1,263,263,263,263,0,0,0,0
118,16,3.39,567,567,548,548,19,19,0,0
118,20,1.44,131,131,131,131,0,0,0,0
118,21,1,33,33,33,33,0,0,0,0
118,23,2.97,203,203,203,203,0,0,0,0
118,24,1,60,60,60,60,0,0,0,0
118,25,1,68,68,68,68,0,0,0,0
118,51,1.45,92,92,92,92,0,0,0,0
118,52,0.53,46,46,46,46,0,0,0,0
118,53,1,14,14,14,14,0,0,0,0
118,63,0.02,8,8,8,8,0,0,0,0
118,64,0.98,326,326,326,326,0,0,0,0
118,66,1,71,71,71,71,0,0,0,0
118,67,2,301,301,301,301,0,0,0,0
118,119,0.99,24,24,24,24,0,0,0,0
118,121,1.87,210,210,210,210,0,0,0,0
118,122,2.14,566,566,566,566,0,0,0,0
118,123,4.97,669,669,669,669,0,0,0,0
118,124,0.01,3,3,3,3,0,0,0,0
118,125,1.55,356,356,356,356,0,0,0,0
118,126,1,159,159,159,159,0,0,0,0
118,127,4,442,442,442,442,0,0,0,0
119,4,3.44,200,200,195,195,6,6,0,0
119,5,15.53,2738,2738,2704,2704,34,34,0,0
119,6,9.43,1851,1851,1851,1851,0,0,0,0
119,7,14.78,2426,2426,2426,2426,0,0,0,0
119,8,8.6,1170,1170,1170,1170,0,0,0,0
119,9,1.04,169,169,169,169,0,0,0,0
119,10,2.77,333,333,332,332,1,1,0,0
119,12,8.41,1115,1115,1115,1115,0,0,0,0
119,13,3.09,282,282,275,275,7,7,0,0
119,14,2,151,151,151,151,0,0,0,0
119,15,1,147,147,147,147,0,0,0,0
119,16,1,148,148,148,148,0,0,0,0
119,17,1,244,244,244,244,0,0,0,0
119,18,2,195,195,195,195,0,0,0,0
119,19,1,77,77,77,77,0,0,0,0
119,20,0.56,46,46,46,46,0,0,0,0
119,22,2,141,141,141,141,0,0,0,0
119,23,0.03,1,1,1,1,0,0,0,0
119,51,2.02,63,63,63,63,0,0,0,0
119,53,0.99,14,14,14,14,0,0,0,0
119,63,1,58,58,58,58,0,0,0,0
119,77,0.98,85,85,85,85,0,0,0,0
119,78,0.02,2,2,2,2,0,0,0,0
119,83,1,25,25,25,25,0,0,0,0
119,115,3,99,99,99,99,0,0,0,0
119,116,2,552,552,552,552,0,0,0,0
119,117,0.98,132,132,132,132,0,0,0,0
119,118,10.02,931,931,931,931,0,0,0,0
119,119,2.58,347,347,347,347,0,0,0,0
119,120,1,137,137,137,137,0,0,0,0
119,122,3.06,414,414,414,414,0,0,0,0
119,127,2,139,139,139,139,0,0,0,0
120,4,2.99,478,478,478,478,0,0,0,0
120,5,12.92,2417,2417,2417,2417,0,0,0,0
120,6,16.72,3598,3598,3241,3241,0,0,358,358
120,7,12.68,2484,2484,2432,2432,0,0,52,52
120,8,3.99,649,649,376,376,273,273,0,0
120,10,0.31,27,27,27,27,0,0,0,0
120,12,1,150,150,150,150,0,0,0,0
120,13,3.24,688,688,688,688,0,0,0,0
120,14,6,611,611,611,611,0,0,0,0
120,15,1.48,120,120,120,120,0,0,0,0
120,16,1.78,259,259,243,243,17,17,0,0
120,19,1,16,16,16,16,0,0,0,0
120,20,1,165,165,165,165,0,0,0,0
120,21,1,121,121,121,121,0,0,0,0
120,53,3.01,86,86,86,86,0,0,0,0
120,61,1,63,63,63,63,0,0,0,0
120,117,3,266,266,266,266,0,0,0,0
120,118,1,112,112,112,112,0,0,0,0
120,119,0.42,153,153,153,153,0,0,0,0
120,121,1,19,19,19,19,0,0,0,0
121,1,0.95,132,132,132,132,0,0,0,0
121,4,6.29,461,461,461,461,0,0,0,0
121,5,5.04,393,393,393,393,0,0,0,0
121,6,12.31,4201,4201,4201,4201,0,0,0,0
121,7,13.63,4031,4031,4031,4031,0,0,0,0
121,8,17.02,1850,1850,1850,1850,0,0,0,0
121,12,1,98,98,98,98,0,0,0,0
121,13,7.64,910,910,910,910,0,0,0,0
121,14,1.61,64,64,64,64,0,0,0,0
121,15,4,178,178,178,178,0,0,0,0
121,16,2.73,571,571,571,571,0,0,0,0
121,17,5,136,136,77,77,58,58,0,0
121,18,1,60,60,60,60,0,0,0,0
121,19,1,30,30,30,30,0,0,0,0
121,20,1.92,200,200,200,200,0,0,0,0
121,62,1,19,19,19,19,0,0,0,0
121,64,1,13,13,13,13,0,0,0,0
121,68,3.15,103,103,103,103,0,0,0,0
121,69,0.85,24,24,24,24,0,0,0,0
121,93,1,45,45,45,45,0,0,0,0
121,116,1.42,380,380,380,380,0,0,0,0
121,117,2,91,91,91,91,0,0,0,0
121,118,2,150,150,150,150,0,0,0,0
121,119,1,31,31,31,31,0,0,0,0
121,126,1,269,269,269,269,0,0,0,0
122,1,0.05,6,6,6,6,0,0,0,0
122,3,0.34,18,18,18,18,0,0,0,0
122,4,2.71,403,403,403,403,0,0,0,0
122,5,10.97,1160,1160,1160,1160,0,0,0,0
122,6,3.83,693,693,693,693,0,0,0,0
122,7,7.89,863,863,863,863,0,0,0,0
122,8,3.47,223,223,223,223,0,0,0,0
122,13,2,318,318,318,318,0,0,0,0
122,14,1,57,57,57,57,0,0,0,0
122,16,1,12,12,0,0,12,12,0,0
122,17,1,78,78,78,78,0,0,0,0
122,18,2,272,272,272,272,0,0,0,0
122,20,0.08,17,17,17,17,0,0,0,0
122,53,1,14,14,14,14,0,0,0,0
122,55,2,41,41,41,41,0,0,0,0
122,62,1,14,14,14,14,0,0,0,0
122,64,1,18,18,18,18,0,0,0,0
122,87,0.44,16,16,16,16,0,0,0,0
122,88,0.56,21,21,21,21,0,0,0,0
122,90,2,94,94,94,94,0,0,0,0
122,92,1,91,91,91,91,0,0,0,0
122,115,0.98,514,514,514,514,0,0,0,0
122,116,3.6,697,697,697,697,0,0,0,0
122,122,1.61,38,38,38,38,0,0,0,0
122,125,3,200,200,200,200,0,0,0,0
123,3,0.66,35,35,35,35,0,0,0,0
123,4,2,113,113,113,113,0,0,0,0
123,5,4.8,385,385,385,385,0,0,0,0
123,6,1,48,48,48,48,0,0,0,0
123,14,1,148,148,148,148,0,0,0,0
123,52,0.21,2,2,2,2,0,0,0,0
123,53,1.79,51,51,51,51,0,0,0,0
123,108,1,68,68,68,68,0,0,0,0
123,109,1,30,30,30,30,0,0,0,0
123,113,1,31,31,31,31,0,0,0,0
123,114,1,13,13,13,13,0,0,0,0
123,115,2,164,164,164,164,0,0,0,0
123,116,2.91,419,419,419,419,0,0,0,0
123,122,0.39,12,12,12,12,0,0,0,0
124,2,1,268,268,268,268,0,0,0,0
124,4,1,143,143,143,143,0,0,0,0
124,5,4,489,489,489,489,0,0,0,0
124,6,0.7,16,16,16,16,0,0,0,0
124,8,0.53,34,34,34,34,0,0,0,0
124,15,2,225,225,225,225,0,0,0,0
124,52,1,77,77,77,77,0,0,0,0
124,54,1,14,14,14,14,0,0,0,0
124,62,1,44,44,44,44,0,0,0,0
124,65,1,27,27,27,27,0,0,0,0
124,72,1,25,25,25,25,0,0,0,0
124,83,0.39,15,15,15,15,0,0,0,0
124,84,9.61,425,425,425,425,0,0,0,0
124,90,1,49,49,49,49,0,0,0,0
124,91,3.99,295,295,295,295,0,0,0,0
124,99,1.01,10,10,10,10,0,0,0,0
124,114,1,237,237,237,237,0,0,0,0
124,116,0.09,19,19,19,19,0,0,0,0
124,119,1,278,278,278,278,0,0,0,0
125,4,4,483,483,483,483,0,0,0,0
125,5,2,200,200,200,200,0,0,0,0
125,6,0.3,7,7,7,7,0,0,0,0
125,8,1.47,66,66,66,66,0,0,0,0
125,15,0.13,20,20,20,20,0,0,0,0
125,16,0.87,134,134,134,134,0,0,0,0
125,54,1,14,14,14,14,0,0,0,0
125,70,1,30,30,30,30,0,0,0,0
125,89,5,168,168,168,168,0,0,0,0
125,91,0.01,2,2,2,2,0,0,0,0
125,99,0.99,19,19,19,19,0,0,0,0
125,126,0.31,16,16,16,16,0,0,0,0
126,5,4.31,400,400,400,400,0,0,0,0
126,6,0.91,228,228,228,228,0,0,0,0
126,7,1,97,97,97,97,0,0,0,0
126,9,0.3,55,55,55,55,0,0,0,0
126,69,1,15,15,15,15,0,0,0,0
126,70,1,26,26,26,26,0,0,0,0
126,77,1.11,26,26,26,26,0,0,0,0
126,78,0.89,25,25,25,25,0,0,0,0
126,80,3.05,87,87,87,87,0,0,0,0
126,81,2.14,64,64,64,64,0,0,0,0
126,82,3.86,89,89,89,89,0,0,0,0
126,97,1,36,36,36,36,0,0,0,0
126,98,0.85,2123,2123,2123,2123,0,0,0,0
126,99,1.15,413,413,413,413,0,0,0,0
126,100,1,28,28,28,28,0,0,0,0
126,107,0.35,19,19,19,19,0,0,0,0
126,108,0.65,36,36,36,36,0,0,0,0
126,112,0.34,14,14,14,14,0,0,0,0
126,117,0.87,122,122,122,122,0,0,0,0
126,118,0.13,17,17,17,17,0,0,0,0
126,119,16,1127,1127,1127,1127,0,0,0,0
126,121,0.6,81,81,81,81,0,0,0,0
126,122,1,8,8,8,8,0,0,0,0
126,126,3.69,292,292,292,292,0,0,0,0
127,6,6.78,631,631,631,631,0,0,0,0
127,8,2.46,247,247,247,247,0,0,0,0
127,9,1.81,238,238,238,238,0,0,0,0
127,14,0.69,51,51,51,51,0,0,0,0
127,64,1,29,29,29,29,0,0,0,0
127,65,1,27,27,27,27,0,0,0,0
127,69,0.27,9,9,9,9,0,0,0,0
127,72,1,25,25,25,25,0,0,0,0
127,73,2,50,50,50,50,0,0,0,0
127,77,1,41,41,41,41,0,0,0,0
127,79,0.58,43,43,43,43,0,0,0,0
127,80,2.95,103,103,103,103,0,0,0,0
127,87,1.95,78,78,78,78,0,0,0,0
127,88,0.05,3,3,3,3,0,0,0,0
127,96,2,54,54,54,54,0,0,0,0
127,101,0.7,14,14,14,14,0,0,0,0
127,102,1,34,34,34,34,0,0,0,0
127,109,1.23,204,204,204,204,0,0,0,0
127,110,0.91,296,296,296,296,0,0,0,0
127,111,0.09,28,28,28,28,0,0,0,0
127,112,0.66,27,27,27,27,0,0,0,0
127,115,3,60,60,60,60,0,0,0,0
127,117,3,150,150,150,150,0,0,0,0
127,118,1,51,51,51,51,0,0,0,0
127,119,1,63,63,63,63,0,0,0,0
127,121,1.4,141,141,141,141,0,0,0,0
127,126,1,77,77,77,77,0,0,0,0
127,127,4,104,104,104,104,0,0,0,0
