x,y,number,ground_area,floor_area,residential_ground_area,residential_floor_area,economic_activity_ground_area,economic_activity_floor_area,cultural_ground_area,cultural_floor_area
0,4,0.37,206,206,206,206,0,0,0,0
0,6,1,357,357,357,357,0,0,0,0
2,0,1,28,28,0,0,28,28,0,0
2,2,1,38,38,38,38,0,0,0,0
2,8,1,9,9,0,0,9,9,0,0
4,2,3,585,585,568,568,17,17,0,0
4,0,1,42,42,42,42,0,0,0,0
6,0,3,175,175,0,0,175,175,0,0
8,0,5.16,1024,1024,1024,1024,0,0,0,0
8,2,1,14,14,0,0,14,14,0,0
10,0,1.46,309,309,309,309,0,0,0,0
12,0,1,60,60,0,0,60,60,0,0
