x,y,number,ground_area,floor_area,residential_ground_area,residential_floor_area,economic_activity_ground_area,economic_activity_floor_area,cultural_ground_area,cultural_floor_area
80,38,2,277,277,89,89,188,188,0,0
88,38,0.55,49,49,0,0,49,49,0,0
88,40,1.4,112,112,0,0,112,112,0,0
90,38,1,485,485,0,0,485,485,0,0
90,40,0.04,3,3,0,0,3,3,0,0
94,24,2.61,774,774,0,0,774,774,0,0
94,26,0.39,46,46,0,0,46,46,0,0
114,34,3,194,194,194,194,0,0,0,0
114,36,2,113,113,113,113,0,0,0,0
116,36,1,178,178,178,178,0,0,0,0
118,32,2,177,177,177,177,0,0,0,0
120,34,1,106,106,106,106,0,0,0,0
122,34,0.86,82,82,82,82,0,0,0,0
122,36,1.14,94,94,94,94,0,0,0,0
