x,y,number,ground_area,floor_area,residential_ground_area,residential_floor_area,economic_activity_ground_area,economic_activity_floor_area,cultural_ground_area,cultural_floor_area
9,41,1,12,12,12,12,0,0,0,0
18,0,0.98,30,30,30,30,0,0,0,0
19,39,1,40,40,40,40,0,0,0,0
27,0,1,21,21,0,0,21,21,0,0
29,21,1,169,169,169,169,0,0,0,0
30,13,1,302,302,302,302,0,0,0,0
42,50,1,15,15,15,15,0,0,0,0
47,39,0.22,123,123,123,123,0,0,0,0
47,40,1.78,729,729,426,426,303,303,0,0
57,38,1,42,42,0,0,42,42,0,0
58,35,1,79,79,0,0,79,79,0,0
58,36,1,69,69,69,69,0,0,0,0
61,47,1.27,279,279,29,29,250,250,0,0
62,47,1.51,338,338,213,213,125,125,0,0
62,48,0.23,45,45,0,0,45,45,0,0
63,29,1,56,56,0,0,56,56,0,0
65,47,3.87,180,180,180,180,0,0,0,0
65,48,0.13,8,8,8,8,0,0,0,0
68,3,1,21,21,0,0,21,21,0,0
68,29,1,42,42,42,42,0,0,0,0
69,28,1,36,36,0,0,36,36,0,0
70,22,2,93,93,0,0,93,93,0,0
71,3,1,61,61,0,0,61,61,0,0
71,30,1,17,17,0,0,17,17,0,0
72,26,1,12,12,0,0,12,12,0,0
72,28,1,13,13,0,0,13,13,0,0
73,19,1,11,11,0,0,11,11,0,0
73,22,0.02,0,0,0,0,0,0,0,0
73,23,0.98,11,11,0,0,11,11,0,0
74,1,1,10,10,0,0,10,10,0,0
74,26,1,246,246,246,246,0,0,0,0
75,20,1,14,14,0,0,14,14,0,0
75,33,1,8,8,0,0,8,8,0,0
76,0,1,11,11,0,0,11,11,0,0
76,3,1,81,81,0,0,81,81,0,0
76,35,4.66,123,123,0,0,123,123,0,0
76,36,0.34,3,3,0,0,3,3,0,0
79,18,2,81,81,0,0,81,81,0,0
79,26,2,274,274,274,274,0,0,0,0
79,27,1,144,144,0,0,144,144,0,0
80,25,0.17,19,19,19,19,0,0,0,0
80,36,2,57,57,57,57,0,0,0,0
81,23,1.24,134,134,134,134,0,0,0,0
81,24,1.76,443,443,443,443,0,0,0,0
81,25,1.83,284,284,284,284,0,0,0,0
81,26,2,215,215,215,215,0,0,0,0
81,27,1,69,69,69,69,0,0,0,0
82,20,1,37,37,0,0,37,37,0,0
82,23,1,78,78,0,0,78,78,0,0
82,29,2,581,581,581,581,0,0,0,0
83,16,1,53,53,0,0,53,53,0,0
84,12,2,419,419,419,419,0,0,0,0
84,17,1,135,135,135,135,0,0,0,0
85,49,1,44,44,44,44,0,0,0,0
86,4,1,34,34,34,34,0,0,0,0
86,48,1,33,33,33,33,0,0,0,0
87,3,2,159,159,159,159,0,0,0,0
87,8,2,777,777,309,309,468,468,0,0
87,14,1,27,27,27,27,0,0,0,0
87,31,1,9,9,0,0,9,9,0,0
88,2,0.1,52,52,0,0,52,52,0,0
88,10,1.02,157,157,157,157,0,0,0,0
88,13,2,859,859,859,859,0,0,0,0
88,32,1,266,266,0,0,266,266,0,0
88,43,1,14,14,0,0,14,14,0,0
89,2,2.87,799,799,346,346,453,453,0,0
89,3,2.8,507,507,206,206,301,301,0,0
89,4,0.22,9,9,0,0,9,9,0,0
89,6,1,72,72,72,72,0,0,0,0
89,9,2.67,725,725,725,725,0,0,0,0
89,10,1.48,435,435,435,435,0,0,0,0
89,11,2.82,586,586,586,586,0,0,0,0
89,12,0.6,107,107,107,107,0,0,0,0
89,13,2.05,223,223,223,223,0,0,0,0
89,20,1,22,22,22,22,0,0,0,0
89,26,1,4,4,0,0,4,4,0,0
89,33,1,66,66,0,0,66,66,0,0
90,12,0.4,71,71,71,71,0,0,0,0
90,13,0.95,258,258,258,258,0,0,0,0
90,14,1,90,90,90,90,0,0,0,0
90,23,1,31,31,0,0,31,31,0,0
90,45,1,11,11,0,0,11,11,0,0
91,4,1.04,154,154,154,154,0,0,0,0
91,5,1.53,561,561,561,561,0,0,0,0
91,6,1.5,515,515,503,503,0,0,12,12
91,9,0.9,208,208,208,208,0,0,0,0
91,10,1.09,165,165,165,165,0,0,0,0
91,11,1.02,280,280,280,280,0,0,0,0
91,12,0.53,58,58,58,58,0,0,0,0
91,13,0.47,52,52,52,52,0,0,0,0
91,24,1,293,293,0,0,293,293,0,0
91,34,1,106,106,0,0,106,106,0,0
92,3,2.81,419,419,285,285,134,134,0,0
92,4,4.04,599,599,599,599,0,0,0,0
92,5,3.3,428,428,428,428,0,0,0,0
92,6,3.28,992,992,992,992,0,0,0,0
92,7,2.21,170,170,170,170,0,0,0,0
92,9,3,613,613,613,613,0,0,0,0
92,34,1,36,36,36,36,0,0,0,0
92,44,1,7,7,0,0,7,7,0,0
93,0,1.88,369,369,320,320,49,49,0,0
93,1,1,177,177,177,177,0,0,0,0
93,2,1.08,140,140,13,13,127,127,0,0
93,3,1.19,226,226,226,226,0,0,0,0
93,4,0.09,11,11,11,11,0,0,0,0
93,34,0.04,2,2,2,2,0,0,0,0
93,35,0.96,38,38,38,38,0,0,0,0
94,0,7.73,1278,1278,1133,1133,145,145,0,0
94,2,4.22,1114,1114,567,567,547,547,0,0
94,3,1.38,321,321,321,321,0,0,0,0
94,4,1.32,179,179,179,179,0,0,0,0
94,47,1,25,25,25,25,0,0,0,0
95,0,2.86,490,490,490,490,0,0,0,0
95,1,0.94,163,163,163,163,0,0,0,0
95,3,3.86,721,721,494,494,227,227,0,0
95,4,0.95,430,430,0,0,430,430,0,0
95,16,1,42,42,42,42,0,0,0,0
95,19,0.08,3,3,3,3,0,0,0,0
95,20,0.92,33,33,33,33,0,0,0,0
95,26,1,18,18,18,18,0,0,0,0
95,32,0.69,19,19,19,19,0,0,0,0
95,33,1.31,28,28,28,28,0,0,0,0
96,3,0.19,48,48,0,0,48,48,0,0
96,48,3,130,130,0,0,130,130,0,0
97,0,1.74,169,169,169,169,0,0,0,0
97,18,1,30,30,30,30,0,0,0,0
97,27,1,6,6,6,6,0,0,0,0
97,31,1,28,28,28,28,0,0,0,0
99,1,2,333,333,333,333,0,0,0,0
99,3,0.03,6,6,6,6,0,0,0,0
99,4,0.02,4,4,4,4,0,0,0,0
99,19,1,26,26,26,26,0,0,0,0
99,22,1,30,30,30,30,0,0,0,0
100,3,1.84,390,390,390,390,0,0,0,0
100,4,1.11,201,201,201,201,0,0,0,0
100,5,1,131,131,131,131,0,0,0,0
101,3,1,231,231,231,231,0,0,0,0
101,10,1,46,46,46,46,0,0,0,0
102,0,0.55,106,106,106,106,0,0,0,0
102,1,1.45,438,438,438,438,0,0,0,0
102,10,1,223,223,223,223,0,0,0,0
103,13,0.1,4,4,0,0,4,4,0,0
103,22,1,214,214,0,0,214,214,0,0
103,26,1,60,60,60,60,0,0,0,0
103,38,0.21,9,9,9,9,0,0,0,0
103,39,0.57,24,24,24,24,0,0,0,0
104,13,0.9,38,38,0,0,38,38,0,0
104,26,1,78,78,0,0,78,78,0,0
104,39,0.22,9,9,9,9,0,0,0,0
105,15,1,33,33,0,0,33,33,0,0
105,43,4,388,388,296,296,92,92,0,0
106,11,1,71,71,0,0,71,71,0,0
108,4,1,24,24,0,0,24,24,0,0
108,29,1,29,29,29,29,0,0,0,0
110,2,1.13,96,96,0,0,96,96,0,0
110,5,1,29,29,0,0,29,29,0,0
110,6,1,60,60,0,0,60,60,0,0
110,17,1,31,31,0,0,31,31,0,0
110,18,1,31,31,0,0,31,31,0,0
110,40,1,27,27,27,27,0,0,0,0
111,2,0.87,14,14,0,0,14,14,0,0
111,3,1,143,143,0,0,143,143,0,0
112,5,1,36,36,0,0,36,36,0,0
112,16,1,151,151,0,0,151,151,0,0
112,27,1,19,19,0,0,19,19,0,0
112,28,1,104,104,0,0,104,104,0,0
115,8,1,21,21,0,0,21,21,0,0
115,10,1,20,20,0,0,20,20,0,0
116,5,1,58,58,0,0,58,58,0,0
117,9,2,96,96,0,0,96,96,0,0
117,10,1,27,27,0,0,27,27,0,0
117,13,1,92,92,92,92,0,0,0,0
118,1,1,17,17,0,0,17,17,0,0
118,10,0.98,83,83,0,0,83,83,0,0
118,61,0.44,240,240,0,0,240,240,0,0
119,10,0.02,1,1,0,0,1,1,0,0
119,61,0.56,300,300,0,0,300,300,0,0
120,3,3,89,89,0,0,89,89,0,0