x,y,number,ground_area,floor_area,residential_ground_area,residential_floor_area,economic_activity_ground_area,economic_activity_floor_area,cultural_ground_area,cultural_floor_area
81,39,2,277,277,89,89,188,188,0,0
89,39,0.55,49,49,0,0,49,49,0,0
89,40,1.4,112,112,0,0,112,112,0,0
90,39,1,485,485,0,0,485,485,0,0
90,40,0.04,3,3,0,0,3,3,0,0
94,25,2.61,774,774,0,0,774,774,0,0
94,26,0.39,46,46,0,0,46,46,0,0
114,35,1.29,68,68,68,68,0,0,0,0
114,37,2,113,113,113,113,0,0,0,0
115,35,1.71,126,126,126,126,0,0,0,0
117,36,1,178,178,178,178,0,0,0,0
119,32,1,93,93,93,93,0,0,0,0
119,33,1,84,84,84,84,0,0,0,0
120,35,1,106,106,106,106,0,0,0,0
123,35,0.86,82,82,82,82,0,0,0,0
123,36,1.14,94,94,94,94,0,0,0,0
